Frame,Timestamp,Width_px,Height_px,Depth_cm,Category,Confidence,X1,Y1,X2,Y2,Priority
3,0.12,144,72,17.7,deep,0.816,341,350,485,422,4
3,0.12,180,91,19.8,deep,0.814,427,437,607,528,4
3,0.12,215,108,18.0,deep,0.812,513,525,728,633,4
4,0.16,148,76,18.1,deep,0.805,337,351,485,427,4
4,0.16,184,95,18.7,deep,0.800,422,438,606,533,4
4,0.16,219,114,17.4,deep,0.797,507,527,726,641,4
8,0.32,160,83,19.2,deep,0.798,322,377,482,460,4
8,0.32,201,104,17.8,deep,0.795,402,471,603,575,4
8,0.32,242,124,19.8,deep,0.800,483,566,725,690,4
9,0.36,163,85,20.7,very_deep,0.847,320,381,483,466,5
9,0.36,203,106,17.4,deep,0.829,400,476,603,582,4
9,0.36,245,129,17.1,deep,0.837,480,571,725,700,4
10,0.40,170,90,18.2,deep,0.904,313,383,483,473,4
10,0.40,214,112,19.9,deep,0.898,391,480,605,592,4
10,0.40,256,136,16.9,deep,0.901,470,575,726,711,4
11,0.44,168,92,19.9,deep,0.913,313,385,481,477,4
11,0.44,215,115,17.7,deep,0.920,391,481,606,596,4
11,0.44,257,138,18.2,deep,0.922,470,578,727,716,4
12,0.48,170,95,17.3,deep,0.924,305,396,475,491,4
12,0.48,209,120,16.7,deep,0.925,382,493,591,613,4
12,0.48,250,144,17.6,deep,0.925,458,592,708,736,4
13,0.52,168,95,20.2,very_deep,0.894,303,403,471,498,5
13,0.52,210,120,18.2,deep,0.895,380,503,590,623,4
13,0.52,251,143,19.5,deep,0.896,456,605,707,748,4
14,0.56,180,106,19.5,deep,0.898,296,402,476,508,4
14,0.56,230,133,16.7,deep,0.897,370,503,600,636,4
14,0.56,275,158,19.7,deep,0.899,443,605,718,763,4
15,0.60,191,105,19.5,deep,0.958,281,413,472,518,4
15,0.60,242,130,19.1,deep,0.955,351,517,593,647,4
15,0.60,290,155,18.9,deep,0.955,422,621,712,776,4
16,0.64,191,117,17.3,deep,0.970,276,416,467,533,4
16,0.64,242,145,17.2,deep,0.970,343,520,585,665,4
16,0.64,288,172,16.3,deep,0.970,413,625,701,797,4
17,0.68,188,120,19.5,deep,0.940,273,423,461,543,4
17,0.68,236,152,18.3,deep,0.939,341,528,577,680,4
17,0.68,282,181,17.6,deep,0.940,410,635,692,816,4
18,0.72,197,120,18.3,deep,0.880,263,436,460,556,4
18,0.72,245,149,18.2,deep,0.876,330,546,575,695,4
18,0.72,295,180,17.1,deep,0.879,395,655,690,835,4
19,0.76,199,130,18.0,deep,0.935,261,441,460,571,4
19,0.76,250,163,19.2,deep,0.931,325,550,575,713,4
19,0.76,300,197,19.3,deep,0.932,390,660,690,857,4
20,0.80,219,135,17.5,deep,0.949,242,446,461,581,4
20,0.80,275,170,19.1,deep,0.949,302,557,577,727,4
20,0.80,329,204,16.8,deep,0.949,363,668,692,872,4
21,0.84,228,141,18.4,deep,0.952,232,450,460,591,4
21,0.84,286,178,19.2,deep,0.949,290,562,576,740,4
21,0.84,343,211,17.8,deep,0.951,348,676,691,887,4
22,0.88,238,147,18.2,deep,0.926,220,466,458,613,4
22,0.88,303,183,16.2,deep,0.926,272,583,575,766,4
22,0.88,363,220,16.4,deep,0.929,327,700,690,920,4
23,0.92,242,154,19.6,deep,0.927,213,471,455,625,4
23,0.92,305,190,16.8,deep,0.926,267,590,572,780,4
23,0.92,365,229,16.9,deep,0.925,321,707,686,936,4
24,0.96,246,158,16.4,deep,0.954,200,480,446,638,4
24,0.96,312,198,18.3,deep,0.952,251,600,563,798,4
24,0.96,374,237,15.8,medium,0.951,301,720,675,957,3
25,1.00,256,171,20.0,very_deep,0.886,182,492,438,663,5
25,1.00,322,215,16.8,deep,0.880,228,616,550,831,4
25,1.00,386,258,18.9,deep,0.880,275,738,661,996,4
26,1.04,270,176,17.1,deep,0.896,171,497,441,673,4
26,1.04,338,219,18.8,deep,0.896,213,622,551,841,4
26,1.04,404,264,15.8,medium,0.899,257,746,661,1010,3
27,1.08,278,175,19.3,deep,0.905,157,511,435,686,4
27,1.08,348,218,18.6,deep,0.901,197,640,545,858,4
27,1.08,419,263,16.9,deep,0.902,236,767,655,1030,4
28,1.12,283,183,18.9,deep,0.889,145,528,428,711,4
28,1.12,361,254,17.0,deep,0.902,180,646,541,900,4
28,1.12,432,304,17.6,deep,0.902,216,776,648,1080,4
29,1.16,283,179,19.7,deep,0.882,137,541,420,720,4
29,1.16,86,47,25.1,critical,0.345,770,396,856,443,6
29,1.16,355,224,17.3,deep,0.885,171,676,526,900,4
29,1.16,106,60,22.5,very_deep,0.320,962,495,1068,555,5
29,1.16,429,268,18.6,deep,0.884,203,812,632,1080,4
29,1.16,127,70,23.6,very_deep,0.313,1155,595,1282,665,5
30,1.20,276,174,17.7,deep,0.902,130,546,406,720,4
30,1.20,345,218,15.9,medium,0.900,162,682,507,900,3
30,1.20,413,262,18.0,deep,0.902,195,818,608,1080,4
31,1.24,269,159,19.4,deep,0.889,123,561,392,720,4
31,1.24,340,199,15.9,medium,0.895,151,701,491,900,3
31,1.24,407,239,15.6,medium,0.893,183,841,590,1080,3
32,1.28,261,140,19.7,deep,0.904,112,580,373,720,4
32,1.28,329,175,18.5,deep,0.907,138,725,467,900,4
32,1.28,395,212,17.4,deep,0.904,166,868,561,1080,4
33,1.32,93,54,22.6,very_deep,0.495,785,422,878,476,5
33,1.32,115,68,21.0,very_deep,0.495,980,527,1095,595,5
33,1.32,137,82,20.3,very_deep,0.511,1176,633,1313,715,5
34,1.36,119,66,22.3,very_deep,0.328,982,535,1101,601,5
34,1.36,141,80,25.1,critical,0.346,1180,642,1321,722,6
35,1.40,98,55,20.4,very_deep,0.413,788,442,886,497,5
35,1.40,127,66,22.6,very_deep,0.389,983,555,1110,621,5
35,1.40,151,80,21.6,very_deep,0.362,1181,666,1332,746,5
39,1.56,113,62,22.3,very_deep,0.482,803,475,916,537,5
39,1.56,140,76,23.1,very_deep,0.473,1006,595,1146,671,5
39,1.56,168,92,20.0,deep,0.481,1207,713,1375,805,4
40,1.60,103,65,21.3,very_deep,0.457,812,482,915,547,5
40,1.60,128,80,21.4,very_deep,0.389,1015,603,1143,683,5
40,1.60,154,96,23.7,very_deep,0.361,1218,725,1372,821,5
41,1.64,114,70,24.8,very_deep,0.323,816,486,930,556,5
41,1.64,140,89,25.1,critical,0.324,1020,607,1160,696,6
41,1.64,168,105,24.4,very_deep,0.338,1223,730,1391,835,5
42,1.68,114,70,20.8,very_deep,0.493,821,508,935,578,5
42,1.68,143,85,23.9,very_deep,0.507,1025,637,1168,722,5
42,1.68,171,102,21.1,very_deep,0.499,1230,765,1401,867,5
43,1.72,117,76,21.1,very_deep,0.344,833,512,950,588,5
43,1.72,144,94,21.9,very_deep,0.371,1042,642,1186,736,5
43,1.72,170,112,22.2,very_deep,0.384,1252,771,1422,883,5
45,1.80,129,79,22.4,very_deep,0.551,843,541,972,620,5
45,1.80,160,98,21.1,very_deep,0.571,1056,677,1216,775,5
45,1.80,192,117,22.8,very_deep,0.598,1268,813,1460,930,5
46,1.84,132,90,20.7,very_deep,0.453,846,547,978,637,5
46,1.84,160,106,20.8,very_deep,0.434,1060,687,1220,793,5
46,1.84,191,134,20.5,very_deep,0.455,1271,821,1462,955,5
47,1.88,128,83,20.9,very_deep,0.456,858,560,986,643,5
47,1.88,160,103,20.6,very_deep,0.428,1072,700,1232,803,5
47,1.88,192,125,24.2,very_deep,0.429,1286,840,1478,965,5
48,1.92,127,95,21.4,very_deep,0.638,873,577,1000,672,5
48,1.92,159,119,20.3,very_deep,0.652,1092,722,1251,841,5
48,1.92,191,141,22.2,very_deep,0.648,1311,867,1502,1008,5
51,2.04,746,380,17.9,deep,0.480,7,472,753,852,4
54,2.16,182,92,19.3,deep,0.932,0,320,182,412,4
54,2.16,227,115,16.6,deep,0.936,0,400,227,515,4
54,2.16,273,137,16.8,deep,0.934,0,481,273,618,4
55,2.20,171,98,19.2,deep,0.919,0,323,171,421,4
55,2.20,211,123,16.8,deep,0.915,0,403,211,526,4
55,2.20,253,147,18.7,deep,0.919,0,485,253,632,4
56,2.24,166,100,19.6,deep,0.898,0,328,166,428,4
56,2.24,207,126,18.9,deep,0.899,0,410,207,536,4
56,2.24,248,151,19.9,deep,0.898,0,492,248,643,4
57,2.28,165,104,20.5,very_deep,0.878,0,333,165,437,5
57,2.28,207,130,19.3,deep,0.888,0,416,207,546,4
57,2.28,250,155,16.8,deep,0.887,0,500,250,655,4
58,2.32,168,86,18.6,deep,0.862,995,451,1163,537,4
58,2.32,156,103,20.1,very_deep,0.854,0,343,156,446,5
58,2.32,214,109,17.9,deep,0.869,1243,563,1457,672,4
58,2.32,202,127,19.4,deep,0.868,0,430,202,557,4
58,2.32,256,130,17.9,deep,0.869,1492,676,1748,806,4
58,2.32,242,154,19.5,deep,0.863,0,516,242,670,4
59,2.36,148,105,18.2,deep,0.915,0,346,148,451,4
59,2.36,90,45,19.4,deep,0.571,685,302,775,347,4
59,2.36,186,134,18.6,deep,0.917,0,431,186,565,4
59,2.36,223,159,18.2,deep,0.918,0,518,223,677,4
59,2.36,135,68,20.0,deep,0.560,1028,453,1163,521,4
60,2.40,141,108,16.9,deep,0.920,0,348,141,456,4
60,2.40,175,135,16.9,deep,0.918,0,436,175,571,4
60,2.40,211,162,19.8,deep,0.918,0,523,211,685,4
61,2.44,138,108,20.3,very_deep,0.916,0,353,138,461,5
61,2.44,179,92,19.8,deep,0.859,1018,478,1197,570,4
61,2.44,173,134,18.3,deep,0.915,0,443,173,577,4
61,2.44,225,114,18.9,deep,0.853,1272,598,1497,712,4
61,2.44,208,161,19.4,deep,0.917,0,531,208,692,4
61,2.44,270,137,16.7,deep,0.857,1527,718,1797,855,4
62,2.48,178,95,16.6,deep,0.913,1040,490,1218,585,4
62,2.48,132,115,17.7,deep,0.846,0,363,132,478,4
62,2.48,221,116,19.5,deep,0.900,1302,615,1523,731,4
62,2.48,165,143,18.8,deep,0.843,0,455,165,598,4
62,2.48,266,139,17.4,deep,0.895,1562,738,1828,877,4
62,2.48,198,173,17.7,deep,0.846,0,545,198,718,4
63,2.52,183,106,19.2,deep,0.830,1050,500,1233,606,4
63,2.52,120,112,22.0,very_deep,0.761,0,371,120,483,5
63,2.52,229,132,19.5,deep,0.817,1313,626,1542,758,4
63,2.52,150,140,19.4,deep,0.752,0,463,150,603,4
63,2.52,276,159,17.0,deep,0.813,1576,751,1852,910,4
63,2.52,180,168,19.2,deep,0.748,0,557,180,725,4
64,2.56,186,107,17.5,deep,0.894,1057,508,1243,615,4
64,2.56,116,112,20.0,very_deep,0.839,0,376,116,488,5
64,2.56,96,50,18.9,deep,0.752,695,322,791,372,4
64,2.56,232,130,18.4,deep,0.899,1323,638,1555,768,4
64,2.56,147,140,21.2,very_deep,0.844,0,471,147,611,5
64,2.56,122,64,20.3,very_deep,0.743,868,402,990,466,5
64,2.56,278,156,17.9,deep,0.901,1587,766,1865,922,4
64,2.56,177,167,20.4,very_deep,0.849,0,566,177,733,5
64,2.56,145,77,19.3,deep,0.746,1042,483,1187,560,4
65,2.60,195,113,18.4,deep,0.881,1082,532,1277,645,4
65,2.60,96,112,24.4,very_deep,0.308,0,388,96,500,5
65,2.60,244,142,17.0,deep,0.877,1353,665,1597,807,4
65,2.60,294,168,16.3,deep,0.875,1623,800,1917,968,4
66,2.64,186,123,19.0,deep,0.899,1091,548,1277,671,4
66,2.64,92,89,23.8,very_deep,0.511,0,396,92,485,5
66,2.64,232,154,18.0,deep,0.897,1365,686,1597,840,4
66,2.64,116,110,21.1,very_deep,0.479,0,495,116,605,5
66,2.64,131,174,25.4,critical,0.379,331,588,462,762,6
66,2.64,280,184,17.9,deep,0.896,1637,823,1917,1007,4
66,2.64,141,133,20.7,very_deep,0.466,0,593,141,726,5
66,2.64,157,209,23.9,very_deep,0.423,398,706,555,915,5
67,2.68,171,128,20.2,very_deep,0.881,1105,555,1276,683,5
67,2.68,78,91,24.2,very_deep,0.453,0,402,78,493,5
67,2.68,108,138,25.2,critical,0.406,258,478,366,616,6
67,2.68,215,163,20.2,very_deep,0.884,1381,692,1596,855,5
67,2.68,96,114,20.9,very_deep,0.448,0,502,96,616,5
67,2.68,134,172,21.7,very_deep,0.447,323,598,457,770,5
67,2.68,258,195,16.8,deep,0.890,1657,831,1915,1026,4
67,2.68,160,205,21.9,very_deep,0.489,388,718,548,923,5
67,2.68,116,137,23.6,very_deep,0.455,0,603,116,740,5
68,2.72,153,133,19.9,deep,0.887,1125,582,1278,715,4
68,2.72,191,166,17.5,deep,0.879,1407,727,1598,893,4
68,2.72,230,199,18.9,deep,0.877,1688,873,1918,1072,4
69,2.76,137,121,21.0,very_deep,0.760,1143,591,1280,712,5
69,2.76,47,56,23.6,very_deep,0.314,0,415,47,471,5
69,2.76,170,150,20.6,very_deep,0.740,1430,741,1600,891,5
69,2.76,60,68,22.7,very_deep,0.303,0,520,60,588,5
69,2.76,203,180,18.4,deep,0.748,1717,890,1920,1070,4
70,2.80,116,105,17.6,deep,0.877,1161,613,1277,718,4
70,2.80,145,131,18.9,deep,0.868,1451,767,1596,898,4
70,2.80,175,157,17.4,deep,0.869,1741,921,1916,1078,4
71,2.84,100,92,21.0,very_deep,0.721,1177,625,1277,717,5
71,2.84,124,115,21.4,very_deep,0.700,1472,782,1596,897,5
71,2.84,150,139,19.8,deep,0.707,1766,938,1916,1077,4
72,2.88,66,53,20.5,very_deep,0.569,1212,667,1278,720,5
72,2.88,82,64,21.0,very_deep,0.561,1516,836,1598,900,5
72,2.88,98,78,22.6,very_deep,0.562,1820,1002,1918,1080,5
78,3.12,213,130,19.4,deep,0.709,1067,490,1280,620,4
78,3.12,263,158,18.7,deep,0.700,1335,615,1598,773,4
78,3.12,319,190,17.9,deep,0.703,1601,738,1920,928,4
79,3.16,141,71,20.1,very_deep,0.780,741,421,882,492,5
79,3.16,203,145,21.0,very_deep,0.752,1077,496,1280,641,5
79,3.16,254,180,19.0,deep,0.747,1346,621,1600,801,4
79,3.16,304,215,17.7,deep,0.747,1616,746,1920,961,4
80,3.20,200,142,21.3,very_deep,0.705,1078,508,1278,650,5
80,3.20,250,176,18.8,deep,0.700,1348,636,1598,812,4
80,3.20,300,214,17.8,deep,0.701,1618,762,1918,976,4
81,3.24,182,145,19.2,deep,0.717,1096,515,1278,660,4
81,3.24,228,182,21.4,very_deep,0.698,1370,643,1598,825,5
81,3.24,272,217,21.3,very_deep,0.701,1645,773,1917,990,5
82,3.28,165,143,22.4,very_deep,0.691,1115,535,1280,678,5
82,3.28,208,180,18.6,deep,0.703,1392,668,1600,848,4
82,3.28,249,218,21.1,very_deep,0.704,1671,800,1920,1018,5
83,3.32,167,84,17.9,deep,0.849,748,453,915,537,4
83,3.32,150,129,19.4,deep,0.716,1128,552,1278,681,4
83,3.32,208,105,18.0,deep,0.849,937,567,1145,672,4
83,3.32,187,161,22.0,very_deep,0.700,1411,690,1598,851,5
83,3.32,248,126,18.3,deep,0.851,1125,681,1373,807,4
83,3.32,226,194,18.9,deep,0.718,1692,827,1918,1021,4
84,3.36,148,143,21.2,very_deep,0.634,1130,550,1278,693,5
84,3.36,187,178,19.4,deep,0.609,1413,688,1600,866,4
84,3.36,223,214,22.2,very_deep,0.614,1697,826,1920,1040,5
85,3.40,170,89,16.9,deep,0.889,763,481,933,570,4
85,3.40,300,156,17.0,deep,0.781,978,301,1278,457,4
85,3.40,122,124,24.7,very_deep,0.403,1156,577,1278,701,5
85,3.40,212,111,19.2,deep,0.886,955,602,1167,713,4
85,3.40,375,194,18.5,deep,0.760,1223,377,1598,571,4
85,3.40,153,152,25.1,critical,0.330,1445,723,1598,875,6
85,3.40,254,134,16.7,deep,0.885,1147,722,1401,856,4
85,3.40,450,234,19.5,deep,0.764,1468,452,1918,686,4
85,3.40,182,183,24.0,very_deep,0.332,1735,867,1917,1050,5
86,3.44,170,87,16.9,deep,0.918,772,486,942,573,4
86,3.44,293,158,18.4,deep,0.699,985,302,1278,460,4
86,3.44,104,130,21.9,very_deep,0.387,1173,578,1277,708,5
86,3.44,213,109,18.7,deep,0.919,965,607,1178,716,4
86,3.44,368,198,20.0,very_deep,0.675,1230,378,1598,576,5
86,3.44,132,159,23.5,very_deep,0.386,1466,731,1598,890,5
86,3.44,258,132,17.3,deep,0.919,1157,728,1415,860,4
86,3.44,442,236,20.3,very_deep,0.676,1476,455,1918,691,5
86,3.44,160,190,24.9,very_deep,0.390,1758,877,1918,1067,5
87,3.48,179,93,19.1,deep,0.853,772,493,951,586,4
87,3.48,292,161,17.3,deep,0.727,986,301,1278,462,4
87,3.48,94,110,23.5,very_deep,0.302,1186,602,1280,712,5
87,3.48,221,115,17.2,deep,0.851,967,617,1188,732,4
87,3.48,365,201,16.9,deep,0.716,1233,377,1598,578,4
87,3.48,266,139,20.0,deep,0.854,1161,741,1427,880,4
87,3.48,437,241,19.9,deep,0.722,1481,452,1918,693,4
88,3.52,185,99,19.4,deep,0.922,781,511,966,610,4
88,3.52,287,154,18.9,deep,0.659,993,312,1280,466,4
88,3.52,231,123,16.4,deep,0.926,976,638,1207,761,4
88,3.52,357,192,18.5,deep,0.656,1243,390,1600,582,4
88,3.52,276,147,18.5,deep,0.927,1172,766,1448,913,4
88,3.52,427,231,20.3,very_deep,0.655,1493,467,1920,698,5
89,3.56,191,111,16.5,deep,0.918,787,517,978,628,4
89,3.56,276,154,21.8,very_deep,0.580,1002,316,1278,470,5
89,3.56,240,136,16.7,deep,0.913,985,647,1225,783,4
89,3.56,345,192,20.1,very_deep,0.574,1253,395,1598,587,5
89,3.56,288,166,18.8,deep,0.916,1182,776,1470,942,4
89,3.56,415,230,19.3,deep,0.581,1503,475,1918,705,4
90,3.60,197,110,17.9,deep,0.873,795,528,992,638,4
90,3.60,273,151,20.5,very_deep,0.585,1007,320,1280,471,5
90,3.60,251,138,17.5,deep,0.874,991,660,1242,798,4
90,3.60,338,189,20.1,very_deep,0.565,1262,401,1600,590,5
90,3.60,301,166,18.7,deep,0.875,1190,792,1491,958,4
90,3.60,407,226,20.9,very_deep,0.568,1513,481,1920,707,5
91,3.64,218,109,17.5,deep,0.917,783,541,1001,650,4
91,3.64,258,150,18.7,deep,0.657,1020,325,1278,475,4
91,3.64,70,43,21.8,very_deep,0.356,1210,530,1280,573,5
91,3.64,265,135,19.5,deep,0.924,987,677,1252,812,4
91,3.64,323,187,18.3,deep,0.655,1275,406,1598,593,4
91,3.64,88,55,23.2,very_deep,0.319,1512,662,1600,717,5
91,3.64,319,163,16.5,deep,0.924,1183,812,1502,975,4
91,3.64,390,225,18.8,deep,0.647,1528,487,1918,712,4
91,3.64,104,65,23.9,very_deep,0.332,1816,795,1920,860,5
92,3.68,207,111,18.1,deep,0.916,805,566,1012,677,4
92,3.68,251,158,19.0,deep,0.665,1026,330,1277,488,4
92,3.68,45,40,21.8,very_deep,0.395,1235,551,1280,591,5
92,3.68,260,140,17.6,deep,0.918,1006,707,1266,847,4
92,3.68,317,188,19.1,deep,0.665,1281,410,1598,598,4
92,3.68,57,50,23.0,very_deep,0.387,1543,690,1600,740,5
92,3.68,314,167,18.0,deep,0.916,1207,850,1521,1017,4
92,3.68,382,226,18.4,deep,0.650,1536,492,1918,718,4
92,3.68,68,59,24.2,very_deep,0.396,1852,828,1920,887,5
93,3.72,224,127,19.9,deep,0.925,807,575,1031,702,4
93,3.72,249,157,20.0,very_deep,0.621,1028,333,1277,490,5
93,3.72,134,76,24.1,very_deep,0.323,1,591,135,667,5
93,3.72,275,158,17.4,deep,0.936,1013,720,1288,878,4
93,3.72,317,197,20.0,very_deep,0.627,1283,415,1600,612,5
93,3.72,169,93,24.7,very_deep,0.305,1,740,170,833,5
93,3.72,329,190,17.7,deep,0.936,1216,863,1545,1053,4
93,3.72,379,238,18.3,deep,0.614,1541,497,1920,735,4
94,3.76,220,120,17.4,deep,0.926,812,590,1032,710,4
94,3.76,252,161,21.2,very_deep,0.647,1028,331,1280,492,5
94,3.76,279,149,17.3,deep,0.928,1011,738,1290,887,4
94,3.76,315,200,18.9,deep,0.660,1285,415,1600,615,4
94,3.76,330,179,17.5,deep,0.927,1217,886,1547,1065,4
94,3.76,379,241,19.3,deep,0.639,1541,497,1920,738,4
95,3.80,303,154,18.6,deep,0.800,0,386,303,540,4
95,3.80,230,163,19.9,deep,0.591,1050,332,1280,495,4
95,3.80,381,192,18.6,deep,0.810,0,483,381,675,4
95,3.80,288,205,21.0,very_deep,0.607,1312,415,1600,620,5
95,3.80,457,230,17.4,deep,0.807,0,580,457,810,4
95,3.80,347,246,19.6,deep,0.604,1573,497,1920,743,4
96,3.84,306,161,17.8,deep,0.754,0,391,306,552,4
96,3.84,227,167,22.8,very_deep,0.557,1053,333,1280,500,5
96,3.84,382,202,18.3,deep,0.765,0,488,382,690,4
96,3.84,283,208,20.5,very_deep,0.560,1317,417,1600,625,5
96,3.84,458,241,19.2,deep,0.766,0,587,458,828,4
96,3.84,339,249,21.2,very_deep,0.563,1581,501,1920,750,5
97,3.88,84,42,21.3,very_deep,0.771,757,321,841,363,5
97,3.88,300,164,18.6,deep,0.763,0,397,300,561,4
97,3.88,215,166,21.7,very_deep,0.512,1065,340,1280,506,5
97,3.88,376,205,19.4,deep,0.757,0,496,376,701,4
97,3.88,269,206,21.2,very_deep,0.516,1331,426,1600,632,5
97,3.88,125,64,19.3,deep,0.755,1137,481,1262,545,4
97,3.88,451,245,18.3,deep,0.755,0,596,451,841,4
97,3.88,323,252,20.9,very_deep,0.515,1597,508,1920,760,5
98,3.92,285,180,18.3,deep,0.833,0,402,285,582,4
98,3.92,200,146,22.6,very_deep,0.608,1078,356,1278,502,5
98,3.92,357,225,16.8,deep,0.830,0,502,357,727,4
98,3.92,251,181,19.6,deep,0.581,1347,445,1598,626,4
98,3.92,428,269,16.5,deep,0.829,0,603,428,872,4
98,3.92,301,219,20.7,very_deep,0.583,1617,533,1918,752,5
99,3.96,280,193,18.1,deep,0.832,0,405,280,598,4
99,3.96,197,149,19.8,deep,0.657,1081,356,1278,505,4
99,3.96,351,242,16.7,deep,0.821,0,506,351,748,4
99,3.96,247,184,21.9,very_deep,0.647,1351,447,1598,631,5
99,3.96,423,274,18.1,deep,0.822,0,618,423,892,4
99,3.96,297,221,19.0,deep,0.645,1621,536,1918,757,4
100,4.00,278,197,17.3,deep,0.829,0,411,278,608,4
100,4.00,195,154,19.3,deep,0.707,1083,358,1278,512,4
100,4.00,350,248,18.0,deep,0.816,0,513,350,761,4
100,4.00,110,55,21.6,very_deep,0.744,961,418,1071,473,5
100,4.00,243,191,18.7,deep,0.698,1355,450,1598,641,4
100,4.00,420,296,16.3,deep,0.815,0,616,420,912,4
100,4.00,132,66,21.2,very_deep,0.736,1153,502,1285,568,5
100,4.00,292,228,19.2,deep,0.697,1626,540,1918,768,4
101,4.04,275,194,18.0,deep,0.813,0,421,275,615,4
101,4.04,84,43,20.8,very_deep,0.744,772,338,856,381,5
101,4.04,183,156,19.1,deep,0.685,1095,361,1278,517,4
101,4.04,345,241,18.9,deep,0.812,0,527,345,768,4
101,4.04,227,194,20.8,very_deep,0.683,1371,452,1598,646,5
101,4.04,413,290,19.1,deep,0.816,0,632,413,922,4
101,4.04,273,234,17.9,deep,0.686,1645,542,1918,776,4
102,4.08,259,210,18.0,deep,0.882,3,432,262,642,4
102,4.08,168,152,22.0,very_deep,0.659,1112,365,1280,517,5
102,4.08,325,261,18.9,deep,0.875,5,541,330,802,4
102,4.08,210,192,20.4,very_deep,0.666,1390,455,1600,647,5
102,4.08,390,315,15.7,medium,0.877,6,648,396,963,3
102,4.08,252,231,21.3,very_deep,0.673,1668,546,1920,777,5
103,4.12,265,218,19.8,deep,0.864,0,437,265,655,4
103,4.12,89,45,19.4,deep,0.783,783,351,872,396,4
103,4.12,165,151,20.7,very_deep,0.701,1115,370,1280,521,5
103,4.12,331,271,19.5,deep,0.851,0,547,331,818,4
103,4.12,205,189,19.4,deep,0.712,1395,462,1600,651,4
103,4.12,397,326,16.7,deep,0.855,0,656,397,982,4
103,4.12,247,229,19.4,deep,0.722,1673,553,1920,782,4
104,4.16,253,228,19.7,deep,0.876,2,442,255,670,4
104,4.16,155,141,21.5,very_deep,0.649,1125,381,1280,522,5
104,4.16,317,284,19.0,deep,0.884,3,553,320,837,4
104,4.16,194,175,21.1,very_deep,0.648,1406,477,1600,652,5
104,4.16,382,341,18.8,deep,0.888,3,665,385,1006,4
104,4.16,233,211,21.8,very_deep,0.651,1687,572,1920,783,5
105,4.20,236,237,19.3,deep,0.901,5,460,241,697,4
105,4.20,137,136,21.7,very_deep,0.664,1143,390,1280,526,5
105,4.20,295,297,18.0,deep,0.894,6,575,301,872,4
105,4.20,170,172,19.5,deep,0.686,1430,486,1600,658,4
105,4.20,354,357,16.8,deep,0.892,7,690,361,1047,4
105,4.20,204,207,21.9,very_deep,0.687,1716,583,1920,790,5
106,4.24,232,246,17.9,deep,0.922,3,467,235,713,4
106,4.24,125,140,20.9,very_deep,0.765,1155,392,1280,532,5
106,4.24,291,306,17.2,deep,0.914,5,585,296,891,4
106,4.24,157,175,21.6,very_deep,0.767,1443,491,1600,666,5
106,4.24,349,368,17.4,deep,0.914,6,702,355,1070,4
106,4.24,187,208,21.3,very_deep,0.765,1733,590,1920,798,5
107,4.28,228,244,16.9,deep,0.902,5,476,233,720,4
107,4.28,94,47,20.3,very_deep,0.828,803,373,897,420,5
107,4.28,120,145,22.2,very_deep,0.717,1160,397,1280,542,5
107,4.28,287,305,18.1,deep,0.909,6,595,293,900,4
107,4.28,150,183,19.2,deep,0.718,1450,497,1600,680,4
107,4.28,345,367,16.3,deep,0.911,7,713,352,1080,4
107,4.28,180,220,21.6,very_deep,0.717,1740,596,1920,816,5
108,4.32,215,230,18.4,deep,0.926,3,490,218,720,4
108,4.32,98,142,22.7,very_deep,0.583,1180,401,1278,543,5
108,4.32,268,288,17.9,deep,0.925,5,612,273,900,4
108,4.32,122,178,20.8,very_deep,0.577,1476,502,1598,680,5
108,4.32,322,344,16.4,deep,0.923,5,736,327,1080,4
108,4.32,147,213,20.0,deep,0.578,1771,603,1918,816,4
109,4.36,210,219,19.5,deep,0.891,3,501,213,720,4
109,4.36,101,52,19.0,deep,0.851,817,385,918,437,4
109,4.36,93,109,22.8,very_deep,0.442,1185,413,1278,522,5
109,4.36,265,274,18.6,deep,0.896,3,626,268,900,4
109,4.36,128,65,18.9,deep,0.853,1020,482,1148,547,4
109,4.36,118,135,24.8,very_deep,0.438,1480,517,1598,652,5
109,4.36,317,328,16.4,deep,0.899,5,752,322,1080,4
109,4.36,155,79,17.1,deep,0.856,1223,578,1378,657,4
109,4.36,142,162,22.1,very_deep,0.443,1776,621,1918,783,5
110,4.40,203,212,18.1,deep,0.889,0,508,203,720,4
110,4.40,100,50,20.8,very_deep,0.779,823,393,923,443,5
110,4.40,83,105,22.5,very_deep,0.449,1197,417,1280,522,5
110,4.40,255,264,18.6,deep,0.886,0,636,255,900,4
110,4.40,102,131,21.2,very_deep,0.454,1498,521,1600,652,5
110,4.40,306,317,17.8,deep,0.886,0,763,306,1080,4
110,4.40,123,157,20.6,very_deep,0.440,1797,626,1920,783,5
111,4.44,201,204,18.6,deep,0.765,0,516,201,720,4
111,4.44,64,97,23.9,very_deep,0.388,1213,425,1277,522,5
111,4.44,252,255,20.4,very_deep,0.754,0,645,252,900,5
111,4.44,79,122,25.4,critical,0.387,1518,531,1597,653,6
111,4.44,302,305,18.2,deep,0.756,0,775,302,1080,4
111,4.44,95,147,23.6,very_deep,0.386,1822,638,1917,785,5
112,4.48,106,59,21.1,very_deep,0.851,840,403,946,462,5
112,4.48,178,177,18.8,deep,0.678,0,543,178,720,4
112,4.48,133,73,20.6,very_deep,0.854,1050,505,1183,578,5
112,4.48,222,220,21.3,very_deep,0.655,0,680,222,900,5
112,4.48,160,87,20.4,very_deep,0.861,1260,606,1420,693,5
112,4.48,267,264,18.6,deep,0.657,0,816,267,1080,4
113,4.52,145,73,20.1,very_deep,0.688,1047,513,1192,586,5
114,4.56,113,62,18.5,deep,0.748,848,415,961,477,4
114,4.56,145,78,21.4,very_deep,0.745,1057,518,1202,596,5
114,4.56,171,94,17.7,deep,0.753,1271,622,1442,716,4
115,4.60,120,70,22.0,very_deep,0.668,858,425,978,495,5
115,4.60,136,116,21.7,very_deep,0.480,1,602,137,718,5
115,4.60,151,87,20.4,very_deep,0.673,1072,531,1223,618,5
115,4.60,170,145,20.9,very_deep,0.475,1,753,171,898,5
115,4.60,181,104,20.6,very_deep,0.672,1286,638,1467,742,5
115,4.60,205,174,21.7,very_deep,0.497,1,903,206,1077,5
116,4.64,119,69,18.8,deep,0.786,868,431,987,500,4
116,4.64,115,58,20.6,very_deep,0.816,1002,458,1117,516,5
116,4.64,150,87,17.8,deep,0.762,1086,538,1236,625,4
116,4.64,179,105,21.3,very_deep,0.779,1303,646,1482,751,5
117,4.68,132,71,18.2,deep,0.725,868,436,1000,507,4
117,4.68,121,87,20.0,very_deep,0.576,1,633,122,720,5
117,4.68,165,89,21.4,very_deep,0.732,1085,546,1250,635,5
117,4.68,152,108,22.1,very_deep,0.554,1,792,153,900,5
117,4.68,198,105,19.6,deep,0.726,1302,656,1500,761,4
117,4.68,184,129,22.7,very_deep,0.562,1,951,185,1080,5
118,4.72,138,78,18.5,deep,0.701,878,447,1016,525,4
118,4.72,174,96,21.5,very_deep,0.697,1097,560,1271,656,5
118,4.72,209,115,21.2,very_deep,0.706,1316,672,1525,787,5
119,4.76,137,85,18.2,deep,0.735,890,452,1027,537,4
119,4.76,173,107,19.7,deep,0.749,1112,565,1285,672,4
119,4.76,205,130,19.9,deep,0.746,1336,677,1541,807,4
120,4.80,99,50,19.3,deep,0.757,821,390,920,440,4
120,4.80,136,82,21.6,very_deep,0.695,897,461,1033,543,5
120,4.80,124,63,19.6,deep,0.768,1027,487,1151,550,4
120,4.80,169,101,21.7,very_deep,0.683,1122,577,1291,678,5
120,4.80,149,75,17.9,deep,0.765,1232,585,1381,660,4
120,4.80,204,123,18.2,deep,0.687,1346,692,1550,815,4
121,4.84,146,86,22.3,very_deep,0.576,897,467,1043,553,5
121,4.84,184,109,20.4,very_deep,0.559,1121,583,1305,692,5
121,4.84,221,130,20.9,very_deep,0.565,1345,701,1566,831,5
122,4.88,150,95,17.3,deep,0.857,915,481,1065,576,4
122,4.88,186,120,20.4,very_deep,0.853,1145,601,1331,721,5
122,4.88,530,322,20.1,very_deep,0.451,0,578,530,900,5
122,4.88,224,143,20.5,very_deep,0.856,1373,722,1597,865,5
122,4.88,636,385,19.6,deep,0.451,0,695,636,1080,4
123,4.92,152,97,21.1,very_deep,0.753,921,490,1073,587,5
123,4.92,190,121,20.2,very_deep,0.769,1152,612,1342,733,5
123,4.92,533,268,19.2,deep,0.436,0,603,533,871,4
123,4.92,228,144,19.4,deep,0.765,1382,736,1610,880,4
123,4.92,640,321,18.8,deep,0.444,0,725,640,1046,4
124,4.96,110,55,20.3,very_deep,0.779,845,416,955,471,5
124,4.96,164,105,22.0,very_deep,0.715,926,496,1090,601,5
124,4.96,416,220,19.4,deep,0.431,0,496,416,716,4
124,4.96,133,67,17.8,deep,0.796,1057,523,1190,590,4
124,4.96,205,131,18.9,deep,0.690,1157,620,1362,751,4
124,4.96,520,275,19.4,deep,0.419,0,621,520,896,4
124,4.96,245,159,18.0,deep,0.696,1390,743,1635,902,4
124,4.96,623,329,19.5,deep,0.426,0,746,623,1075,4
125,5.00,173,113,19.6,deep,0.902,940,512,1113,625,4
125,5.00,216,139,17.1,deep,0.900,1176,641,1392,780,4
125,5.00,260,168,19.8,deep,0.900,1411,768,1671,936,4
126,5.04,178,120,20.7,very_deep,0.769,948,522,1126,642,5
126,5.04,113,58,21.0,very_deep,0.760,860,437,973,495,5
126,5.04,142,72,21.1,very_deep,0.764,1075,546,1217,618,5
126,5.04,220,151,20.7,very_deep,0.764,1186,652,1406,803,5
126,5.04,265,180,20.7,very_deep,0.762,1423,783,1688,963,5
126,5.04,171,86,18.8,deep,0.760,1290,656,1461,742,4
127,5.08,180,122,17.1,deep,0.862,958,531,1138,653,4
127,5.08,115,58,20.7,very_deep,0.815,863,443,978,501,5
127,5.08,225,151,17.4,deep,0.860,1198,665,1423,816,4
127,5.08,269,183,20.2,very_deep,0.860,1438,797,1707,980,5
128,5.12,198,132,19.8,deep,0.881,968,555,1166,687,4
128,5.12,131,69,21.0,very_deep,0.738,866,452,997,521,5
128,5.12,246,165,18.8,deep,0.877,1212,693,1458,858,4
128,5.12,165,86,19.4,deep,0.743,1081,565,1246,651,4
128,5.12,295,198,19.8,deep,0.879,1455,832,1750,1030,4
128,5.12,198,103,18.7,deep,0.739,1298,678,1496,781,4
129,5.16,213,142,17.9,deep,0.898,972,561,1185,703,4
129,5.16,265,179,19.8,deep,0.883,1216,701,1481,880,4
129,5.16,315,215,16.9,deep,0.882,1462,841,1777,1056,4
130,5.20,200,136,18.9,deep,0.908,995,576,1195,712,4
130,5.20,128,65,18.6,deep,0.789,882,471,1010,536,4
130,5.20,250,170,16.4,deep,0.908,1243,720,1493,890,4
130,5.20,300,205,17.2,deep,0.909,1492,863,1792,1068,4
131,5.24,220,130,19.5,deep,0.881,997,587,1217,717,4
131,5.24,275,162,19.0,deep,0.879,1247,735,1522,897,4
131,5.24,330,196,18.9,deep,0.875,1496,881,1826,1077,4
132,5.28,147,74,20.4,very_deep,0.829,891,496,1038,570,5
132,5.28,212,107,21.3,very_deep,0.533,1025,613,1237,720,5
132,5.28,266,133,20.8,very_deep,0.545,1281,767,1547,900,5
133,5.32,158,79,21.1,very_deep,0.785,885,502,1043,581,5
134,5.36,155,81,19.6,deep,0.821,901,511,1056,592,4
134,5.36,194,101,20.7,very_deep,0.814,1127,640,1321,741,5
134,5.36,233,123,18.3,deep,0.820,1352,767,1585,890,4
135,5.40,170,85,19.0,deep,0.803,903,532,1073,617,4
135,5.40,212,107,20.5,very_deep,0.796,1130,665,1342,772,5
135,5.40,255,129,20.3,very_deep,0.798,1356,798,1611,927,5
136,5.44,156,94,19.0,deep,0.876,932,541,1088,635,4
136,5.44,195,116,19.8,deep,0.884,1167,677,1362,793,4
136,5.44,233,140,18.4,deep,0.881,1400,812,1633,952,4
137,5.48,156,95,20.3,very_deep,0.887,941,551,1097,646,5
137,5.48,195,118,19.5,deep,0.885,1177,690,1372,808,4
137,5.48,234,143,17.0,deep,0.881,1413,827,1647,970,4
138,5.52,182,103,20.0,very_deep,0.895,941,573,1123,676,5
138,5.52,228,128,17.3,deep,0.890,1177,717,1405,845,4
138,5.52,273,154,16.3,deep,0.894,1413,861,1686,1015,4
139,5.56,187,115,17.7,deep,0.851,946,583,1133,698,4
139,5.56,233,143,19.4,deep,0.836,1185,730,1418,873,4
139,5.56,280,172,17.5,deep,0.845,1422,876,1702,1048,4
140,5.60,175,112,18.7,deep,0.872,978,595,1153,707,4
140,5.60,217,142,19.8,deep,0.872,1225,743,1442,885,4
140,5.60,264,170,16.8,deep,0.875,1467,892,1731,1062,4
141,5.64,176,104,17.3,deep,0.892,986,611,1162,715,4
141,5.64,220,130,18.4,deep,0.893,1232,765,1452,895,4
141,5.64,265,156,18.7,deep,0.889,1480,917,1745,1073,4
142,5.68,55,28,21.2,very_deep,0.491,846,337,901,365,5
145,5.80,76,39,23.0,very_deep,0.349,1075,438,1151,477,5
145,5.80,90,46,25.1,critical,0.351,1291,526,1381,572,6
147,5.88,297,151,17.1,deep,0.832,0,447,297,598,4
147,5.88,372,190,19.1,deep,0.830,0,558,372,748,4
147,5.88,447,229,16.3,deep,0.829,0,671,447,900,4
147,5.88,90,45,20.4,very_deep,0.565,1308,541,1398,586,5
148,5.92,296,151,18.2,deep,0.804,0,462,296,613,4
148,5.92,64,32,22.8,very_deep,0.540,881,370,945,402,5
148,5.92,370,189,17.4,deep,0.807,0,578,370,767,4
148,5.92,443,226,19.0,deep,0.806,0,695,443,921,4
149,5.96,285,162,17.3,deep,0.787,0,468,285,630,4
149,5.96,64,33,21.4,very_deep,0.572,886,373,950,406,5
149,5.96,353,200,16.7,deep,0.774,0,587,353,787,4
149,5.96,425,240,18.1,deep,0.775,0,705,425,945,4
150,6.00,280,163,20.0,deep,0.825,0,478,280,641,4
150,6.00,350,203,18.3,deep,0.828,0,598,350,801,4
150,6.00,420,243,17.4,deep,0.827,0,718,420,961,4
151,6.04,279,175,19.6,deep,0.770,1,482,280,657,4
151,6.04,66,33,19.6,deep,0.605,896,382,962,415,4
151,6.04,350,218,17.2,deep,0.776,1,603,351,821,4
151,6.04,419,262,17.3,deep,0.777,2,723,421,985,4
152,6.08,263,174,19.7,deep,0.821,0,502,263,676,4
152,6.08,328,217,19.5,deep,0.821,0,628,328,845,4
152,6.08,394,260,18.7,deep,0.822,1,753,395,1013,4
153,6.12,256,181,20.3,very_deep,0.823,0,510,256,691,5
153,6.12,69,36,20.7,very_deep,0.569,912,400,981,436,5
153,6.12,317,225,19.4,deep,0.822,0,638,317,863,4
153,6.12,86,45,20.5,very_deep,0.560,1141,500,1227,545,5
153,6.12,382,270,18.8,deep,0.821,0,766,382,1036,4
153,6.12,102,52,21.1,very_deep,0.552,1370,601,1472,653,5
154,6.16,247,186,19.3,deep,0.854,1,517,248,703,4
154,6.16,71,37,20.7,very_deep,0.506,920,403,991,440,5
154,6.16,309,233,17.1,deep,0.841,2,647,311,880,4
154,6.16,371,279,18.9,deep,0.842,2,777,373,1056,4
155,6.20,226,172,17.7,deep,0.825,1,545,227,717,4
155,6.20,74,39,23.3,very_deep,0.404,931,416,1005,455,5
155,6.20,281,216,17.5,deep,0.821,2,681,283,897,4
155,6.20,87,49,24.4,very_deep,0.414,1166,521,1253,570,5
155,6.20,340,260,18.5,deep,0.821,2,817,342,1077,4
155,6.20,107,59,22.1,very_deep,0.423,1398,626,1505,685,5
156,6.24,214,162,18.2,deep,0.770,3,558,217,720,4
156,6.24,77,40,19.6,deep,0.706,936,421,1013,461,4
156,6.24,266,204,20.0,very_deep,0.770,1,696,267,900,5
156,6.24,96,50,19.4,deep,0.698,1170,527,1266,577,4
156,6.24,319,242,20.1,very_deep,0.765,6,838,325,1080,5
156,6.24,115,60,20.6,very_deep,0.704,1405,632,1520,692,5
157,6.28,197,149,19.9,deep,0.798,0,571,197,720,4
157,6.28,247,185,17.4,deep,0.804,0,715,247,900,4
157,6.28,296,223,17.3,deep,0.807,0,857,296,1080,4
158,6.32,167,121,21.5,very_deep,0.703,0,595,167,716,5
158,6.32,82,42,23.8,very_deep,0.398,955,443,1037,485,5
158,6.32,206,150,20.0,very_deep,0.737,1,745,207,895,5
158,6.32,247,182,18.4,deep,0.732,1,893,248,1075,4
158,6.32,124,62,23.9,very_deep,0.423,1432,666,1556,728,5
159,6.36,130,106,19.7,deep,0.708,0,611,130,717,4
159,6.36,81,44,24.8,very_deep,0.413,962,451,1043,495,5
159,6.36,162,134,20.3,very_deep,0.704,0,763,162,897,5
159,6.36,103,55,22.9,very_deep,0.399,1202,563,1305,618,5
159,6.36,195,160,19.4,deep,0.694,0,917,195,1077,4
159,6.36,123,66,22.3,very_deep,0.396,1443,676,1566,742,5
160,6.40,100,90,22.0,very_deep,0.535,0,626,100,716,5
160,6.40,87,47,21.5,very_deep,0.329,966,456,1053,503,5
160,6.40,126,113,22.2,very_deep,0.566,0,783,126,896,5
160,6.40,109,59,22.7,very_deep,0.334,1207,571,1316,630,5
160,6.40,166,136,21.6,very_deep,0.572,0,940,166,1076,5
160,6.40,132,71,21.7,very_deep,0.333,1448,685,1580,756,5
161,6.44,89,46,23.5,very_deep,0.455,976,466,1065,512,5
161,6.44,111,57,22.4,very_deep,0.458,1220,583,1331,640,5
161,6.44,134,67,20.6,very_deep,0.466,1463,701,1597,768,5
162,6.48,85,49,24.9,very_deep,0.376,995,483,1080,532,5
162,6.48,107,60,22.7,very_deep,0.330,1243,605,1350,665,5
162,6.48,128,72,22.7,very_deep,0.315,1492,726,1620,798,5
163,6.52,91,50,24.9,very_deep,0.410,1002,491,1093,541,5
163,6.52,112,61,22.7,very_deep,0.434,1255,615,1367,676,5
163,6.52,136,74,20.0,very_deep,0.457,1505,737,1641,811,5
164,6.56,91,50,21.3,very_deep,0.408,1012,500,1103,550,5
164,6.56,114,61,24.7,very_deep,0.416,1266,626,1380,687,5
164,6.56,138,73,23.1,very_deep,0.436,1518,752,1656,825,5
165,6.60,91,54,22.8,very_deep,0.461,1036,521,1127,575,5
165,6.60,113,66,20.9,very_deep,0.417,1297,652,1410,718,5
165,6.60,136,80,22.2,very_deep,0.420,1556,783,1692,863,5
168,6.72,262,133,20.3,very_deep,0.709,1015,260,1277,393,5
168,6.72,329,166,19.1,deep,0.700,1268,326,1597,492,4
168,6.72,396,200,18.5,deep,0.698,1521,391,1917,591,4
170,6.80,261,135,20.5,very_deep,0.662,1016,265,1277,400,5
170,6.80,326,169,19.1,deep,0.648,1271,331,1597,500,4
170,6.80,390,197,19.9,deep,0.485,80,681,470,878,4
170,6.80,392,203,18.2,deep,0.652,1525,397,1917,600,4
170,6.80,466,236,18.6,deep,0.503,96,817,562,1053,4
171,6.84,260,140,20.6,very_deep,0.659,1018,267,1278,407,5
171,6.84,310,165,20.7,very_deep,0.364,46,550,356,715,5
171,6.84,324,173,21.3,very_deep,0.644,1273,335,1597,508,5
171,6.84,392,205,22.3,very_deep,0.321,58,688,450,893,5
171,6.84,389,209,19.2,deep,0.650,1528,402,1917,611,4
171,6.84,465,246,22.5,very_deep,0.337,71,826,536,1072,5
172,6.88,253,144,18.6,deep,0.656,1025,271,1278,415,4
172,6.88,316,177,20.8,very_deep,0.647,1282,340,1598,517,5
172,6.88,379,215,20.2,very_deep,0.652,1538,407,1917,622,5
173,6.92,248,141,21.5,very_deep,0.682,1030,272,1278,413,5
173,6.92,190,97,19.0,deep,0.658,226,563,416,660,4
173,6.92,309,175,19.1,deep,0.681,1288,342,1597,517,4
173,6.92,236,122,19.6,deep,0.662,282,703,518,825,4
173,6.92,370,210,18.5,deep,0.685,1547,411,1917,621,4
173,6.92,284,145,20.1,very_deep,0.669,338,845,622,990,5
174,6.96,213,109,21.3,very_deep,0.704,210,566,423,675,5
174,6.96,245,144,19.6,deep,0.673,1033,273,1278,417,4
174,6.96,266,136,20.7,very_deep,0.712,261,707,527,843,5
174,6.96,306,176,18.1,deep,0.660,1292,345,1598,521,4
174,6.96,319,165,18.2,deep,0.717,312,848,631,1013,4
174,6.96,368,212,17.9,deep,0.662,1550,413,1918,625,4
175,7.00,233,136,20.3,very_deep,0.680,1045,281,1278,417,5
175,7.00,292,168,19.2,deep,0.659,1306,353,1598,521,4
175,7.00,351,203,18.4,deep,0.666,1567,423,1918,626,4
176,7.04,227,132,19.4,deep,0.717,1051,285,1278,417,4
176,7.04,283,164,17.6,deep,0.700,1315,357,1598,521,4
176,7.04,341,198,18.9,deep,0.705,1577,428,1918,626,4
177,7.08,222,134,18.0,deep,0.708,1056,287,1278,421,4
177,7.08,277,167,18.0,deep,0.714,1321,360,1598,527,4
177,7.08,332,200,17.8,deep,0.718,1586,432,1918,632,4
178,7.12,213,138,18.6,deep,0.753,1065,288,1278,426,4
178,7.12,266,171,18.4,deep,0.758,1332,361,1598,532,4
178,7.12,318,205,17.2,deep,0.760,1600,433,1918,638,4
179,7.16,320,166,16.7,deep,0.902,70,440,390,606,4
179,7.16,202,136,18.9,deep,0.708,1076,290,1278,426,4
179,7.16,398,208,17.1,deep,0.891,92,550,490,758,4
179,7.16,255,170,18.1,deep,0.708,1343,362,1598,532,4
179,7.16,477,251,15.7,medium,0.891,110,660,587,911,3
179,7.16,306,202,19.8,deep,0.713,1612,436,1918,638,4
180,7.20,318,172,19.0,deep,0.853,70,445,388,617,4
180,7.20,202,136,19.3,deep,0.648,1076,291,1278,427,4
180,7.20,391,216,17.6,deep,0.842,91,556,482,772,4
180,7.20,252,170,21.8,very_deep,0.646,1346,365,1598,535,5
180,7.20,469,260,17.0,deep,0.843,108,667,577,927,4
180,7.20,303,205,17.8,deep,0.650,1615,437,1918,642,4
181,7.24,331,180,18.8,deep,0.763,51,450,382,630,4
181,7.24,198,134,21.4,very_deep,0.642,1080,293,1278,427,5
181,7.24,412,228,18.5,deep,0.782,63,562,475,790,4
181,7.24,248,167,20.0,very_deep,0.630,1350,366,1598,533,5
181,7.24,491,273,18.7,deep,0.781,77,675,568,948,4
181,7.24,298,201,18.1,deep,0.630,1620,440,1918,641,4
182,7.28,191,125,22.0,very_deep,0.612,1087,301,1278,426,5
182,7.28,327,207,21.2,very_deep,0.545,28,460,355,667,5
182,7.28,63,44,20.7,very_deep,0.465,0,206,63,250,5
182,7.28,238,156,20.3,very_deep,0.615,1360,377,1598,533,5
182,7.28,405,259,18.2,deep,0.568,42,576,447,835,4
182,7.28,78,55,22.9,very_deep,0.464,0,257,78,312,5
182,7.28,287,188,18.7,deep,0.623,1631,452,1918,640,4
182,7.28,490,310,19.2,deep,0.562,51,691,541,1001,4
182,7.28,95,67,24.8,very_deep,0.458,0,308,95,375,5
183,7.32,359,201,17.8,deep,0.716,17,476,376,677,4
183,7.32,182,125,19.3,deep,0.616,1096,301,1278,426,4
183,7.32,60,44,21.2,very_deep,0.486,0,207,60,251,5
183,7.32,449,253,17.7,deep,0.713,21,595,470,848,4
183,7.32,228,156,22.4,very_deep,0.605,1370,376,1598,532,5
183,7.32,76,57,20.4,very_deep,0.510,0,258,76,315,5
183,7.32,536,305,18.1,deep,0.721,26,713,562,1018,4
183,7.32,275,186,18.7,deep,0.609,1643,452,1918,638,4
183,7.32,91,66,22.2,very_deep,0.506,0,311,91,377,5
184,7.36,326,219,17.9,deep,0.728,10,477,336,696,4
184,7.36,178,123,22.1,very_deep,0.548,1100,302,1278,425,5
184,7.36,56,36,23.5,very_deep,0.453,0,211,56,247,5
184,7.36,419,276,17.9,deep,0.717,2,595,421,871,4
184,7.36,225,151,19.2,deep,0.530,1373,380,1598,531,4
184,7.36,70,43,24.3,very_deep,0.459,0,265,70,308,5
184,7.36,481,330,19.2,deep,0.710,16,716,497,1046,4
184,7.36,270,183,21.8,very_deep,0.530,1648,455,1918,638,5
184,7.36,82,53,20.7,very_deep,0.454,1,318,83,371,5
185,7.40,363,222,20.6,very_deep,0.679,0,498,363,720,5
185,7.40,171,112,22.8,very_deep,0.534,1107,311,1278,423,5
185,7.40,48,32,24.5,very_deep,0.446,0,215,48,247,5
185,7.40,451,277,17.9,deep,0.646,0,623,451,900,4
185,7.40,213,140,23.4,very_deep,0.523,1385,390,1598,530,5
185,7.40,60,42,24.8,very_deep,0.459,0,268,60,310,5
185,7.40,542,333,16.7,deep,0.658,0,747,542,1080,4
185,7.40,257,169,21.5,very_deep,0.525,1661,467,1918,636,5
185,7.40,72,49,20.9,very_deep,0.450,0,323,72,372,5
186,7.44,311,217,19.2,deep,0.611,0,503,311,720,4
186,7.44,168,105,21.8,very_deep,0.529,1110,316,1278,421,5
186,7.44,48,33,22.3,very_deep,0.354,0,215,48,248,5
186,7.44,401,270,19.5,deep,0.600,0,630,401,900,4
186,7.44,211,131,21.2,very_deep,0.507,1387,396,1598,527,5
186,7.44,61,43,20.9,very_deep,0.405,0,268,61,311,5
186,7.44,468,325,20.5,very_deep,0.598,0,755,468,1080,5
186,7.44,252,157,22.8,very_deep,0.515,1666,475,1918,632,5
186,7.44,73,51,21.1,very_deep,0.400,0,322,73,373,5
187,7.48,162,101,18.8,deep,0.657,1116,317,1278,418,4
187,7.48,321,205,20.4,very_deep,0.551,0,515,321,720,5
187,7.48,36,32,24.8,very_deep,0.331,0,218,36,250,5
187,7.48,203,125,22.1,very_deep,0.625,1395,397,1598,522,5
187,7.48,388,257,20.7,very_deep,0.576,0,643,388,900,5
187,7.48,46,40,23.9,very_deep,0.346,0,272,46,312,5
187,7.48,243,151,18.3,deep,0.635,1675,476,1918,627,4
187,7.48,456,308,18.0,deep,0.571,0,772,456,1080,4
187,7.48,56,48,21.6,very_deep,0.352,0,327,56,375,5
188,7.52,150,80,19.1,deep,0.685,1128,321,1278,401,4
188,7.52,260,178,21.8,very_deep,0.513,0,542,260,720,5
188,7.52,32,29,21.1,very_deep,0.488,0,221,32,250,5
188,7.52,186,100,21.5,very_deep,0.675,1412,401,1598,501,5
188,7.52,148,74,19.8,deep,0.524,818,537,966,611,4
188,7.52,326,223,19.6,deep,0.504,0,677,326,900,4
188,7.52,41,36,22.4,very_deep,0.491,0,276,41,312,5
188,7.52,222,122,19.4,deep,0.680,1696,481,1918,603,4
188,7.52,395,267,20.4,very_deep,0.507,0,813,395,1080,5
188,7.52,50,44,21.0,very_deep,0.490,0,331,50,375,5
189,7.56,136,79,18.5,deep,0.707,1142,321,1278,400,4
189,7.56,121,68,21.6,very_deep,0.643,660,432,781,500,5
189,7.56,229,170,20.1,very_deep,0.524,2,550,231,720,5
189,7.56,28,34,22.9,very_deep,0.423,0,218,28,252,5
189,7.56,170,99,21.3,very_deep,0.672,1428,402,1598,501,5
189,7.56,154,84,21.8,very_deep,0.635,823,541,977,625,5
189,7.56,287,213,19.0,deep,0.517,3,687,290,900,4
189,7.56,37,38,21.9,very_deep,0.435,0,275,37,313,5
189,7.56,202,119,21.1,very_deep,0.676,1716,482,1918,601,5
189,7.56,185,102,21.6,very_deep,0.639,988,648,1173,750,5
189,7.56,343,255,19.8,deep,0.516,5,825,348,1080,4
189,7.56,45,46,22.0,very_deep,0.438,0,330,45,376,5
190,7.60,127,80,20.7,very_deep,0.727,1151,322,1278,402,5
190,7.60,26,31,24.7,very_deep,0.485,0,221,26,252,5
190,7.60,232,157,23.6,very_deep,0.392,0,563,232,720,5
190,7.60,160,97,19.4,deep,0.722,1438,405,1598,502,4
190,7.60,32,40,21.0,very_deep,0.497,0,276,32,316,5
190,7.60,281,195,23.5,very_deep,0.427,2,705,283,900,5
190,7.60,192,116,19.5,deep,0.728,1726,486,1918,602,4
190,7.60,38,46,24.0,very_deep,0.490,0,332,38,378,5
190,7.60,337,234,21.3,very_deep,0.414,3,846,340,1080,5
191,7.64,123,78,19.3,deep,0.694,1155,325,1278,403,4
191,7.64,215,142,19.5,deep,0.671,3,578,218,720,4
191,7.64,115,71,19.3,deep,0.658,666,450,781,521,4
191,7.64,272,178,19.6,deep,0.689,3,722,275,900,4
191,7.64,155,98,19.5,deep,0.674,1443,407,1598,505,4
191,7.64,141,89,21.9,very_deep,0.638,832,562,973,651,5
191,7.64,325,213,20.1,very_deep,0.698,5,867,330,1080,5
191,7.64,185,115,20.6,very_deep,0.676,1733,488,1918,603,5
191,7.64,172,106,20.9,very_deep,0.635,998,675,1170,781,5
192,7.68,135,71,21.4,very_deep,0.717,668,470,803,541,5
192,7.68,115,62,20.8,very_deep,0.593,1163,335,1278,397,5
192,7.68,170,91,18.8,deep,0.712,835,586,1005,677,4
192,7.68,143,76,20.0,deep,0.574,1455,420,1598,496,4
192,7.68,22,37,22.4,very_deep,0.431,0,281,22,318,5
192,7.68,205,109,21.2,very_deep,0.717,1002,703,1207,812,5
192,7.68,172,93,21.2,very_deep,0.583,1746,503,1918,596,5
192,7.68,27,44,22.9,very_deep,0.419,0,338,27,382,5
193,7.72,137,75,18.0,deep,0.763,671,477,808,552,4
193,7.72,98,72,21.0,very_deep,0.564,1182,336,1280,408,5
193,7.72,172,93,21.4,very_deep,0.771,840,598,1012,691,5
193,7.72,123,91,21.1,very_deep,0.553,1477,420,1600,511,5
193,7.72,220,116,23.0,very_deep,0.308,1,782,221,898,5
193,7.72,208,113,20.2,very_deep,0.766,1007,717,1215,830,5
193,7.72,146,108,23.3,very_deep,0.555,1772,505,1918,613,5
193,7.72,265,140,24.6,very_deep,0.309,1,938,266,1078,5
194,7.76,131,83,20.0,very_deep,0.826,676,482,807,565,5
194,7.76,95,57,24.3,very_deep,0.432,1183,341,1278,398,5
194,7.76,163,103,18.3,deep,0.826,845,602,1008,705,4
194,7.76,118,71,21.1,very_deep,0.429,1480,426,1598,497,5
194,7.76,196,123,20.5,very_deep,0.827,1015,723,1211,846,5
194,7.76,143,85,20.4,very_deep,0.426,1775,511,1918,596,5
195,7.80,139,82,20.3,very_deep,0.815,682,505,821,587,5
195,7.80,82,51,23.1,very_deep,0.438,1198,346,1280,397,5
195,7.80,183,102,20.9,very_deep,0.801,853,633,1036,735,5
195,7.80,102,64,24.6,very_deep,0.420,1498,432,1600,496,5
195,7.80,213,121,20.7,very_deep,0.804,1025,760,1238,881,5
195,7.80,122,78,23.7,very_deep,0.413,1798,518,1920,596,5
196,7.84,151,94,17.5,deep,0.879,685,511,836,605,4
196,7.84,70,45,21.3,very_deep,0.528,1210,348,1280,393,5
196,7.84,191,117,19.7,deep,0.884,856,640,1047,757,4
196,7.84,88,57,20.9,very_deep,0.513,1512,435,1600,492,5
196,7.84,229,141,18.3,deep,0.883,1027,767,1256,908,4
196,7.84,105,69,22.9,very_deep,0.511,1815,522,1920,591,5
197,7.88,153,94,19.6,deep,0.839,685,523,838,617,4
197,7.88,65,50,24.6,very_deep,0.474,1215,348,1280,398,5
197,7.88,190,119,17.5,deep,0.830,857,653,1047,772,4
197,7.88,82,62,23.4,very_deep,0.481,1518,436,1600,498,5
197,7.88,226,142,19.2,deep,0.831,1030,785,1256,927,4
197,7.88,98,75,22.0,very_deep,0.494,1822,523,1920,598,5
198,7.92,151,100,18.3,deep,0.918,696,546,847,646,4
198,7.92,189,125,17.6,deep,0.921,871,682,1060,807,4
198,7.92,226,148,19.5,deep,0.921,1046,820,1272,968,4
199,7.96,159,123,18.8,deep,0.898,698,552,857,675,4
199,7.96,198,153,18.8,deep,0.900,873,690,1071,843,4
199,7.96,240,184,18.8,deep,0.901,1047,828,1287,1012,4
200,8.00,162,100,20.2,very_deep,0.908,705,576,867,676,5
200,8.00,205,125,19.1,deep,0.914,881,720,1086,845,4
200,8.00,246,148,18.0,deep,0.913,1057,865,1303,1013,4
201,8.04,163,116,17.3,deep,0.931,707,577,870,693,4
201,8.04,201,143,17.2,deep,0.931,886,722,1087,865,4
201,8.04,243,174,18.7,deep,0.930,1062,866,1305,1040,4
202,8.08,168,106,20.6,very_deep,0.816,715,606,883,712,5
202,8.08,211,133,17.7,deep,0.840,895,758,1106,891,4
202,8.08,253,158,17.1,deep,0.844,1073,912,1326,1070,4
240,9.60,70,38,21.7,very_deep,0.351,1207,352,1277,390,5
240,9.60,89,45,23.6,very_deep,0.338,1508,441,1597,486,5
240,9.60,106,55,21.5,very_deep,0.347,1811,528,1917,583,5
244,9.76,444,225,22.5,very_deep,0.343,366,466,810,691,5
259,10.36,200,100,21.2,very_deep,0.730,1720,773,1920,873,5
260,10.40,116,64,20.2,very_deep,0.450,1162,526,1278,590,5
260,10.40,145,77,22.8,very_deep,0.414,1453,661,1598,738,5
260,10.40,173,94,22.0,very_deep,0.420,1745,793,1918,887,5
261,10.44,106,71,21.9,very_deep,0.471,1172,532,1278,603,5
261,10.44,133,88,20.8,very_deep,0.479,1465,665,1598,753,5
261,10.44,160,106,23.4,very_deep,0.477,1757,797,1917,903,5
262,10.48,72,57,20.3,very_deep,0.517,1208,560,1280,617,5
262,10.48,89,72,22.1,very_deep,0.521,1511,700,1600,772,5
262,10.48,107,87,23.9,very_deep,0.526,1813,840,1920,927,5
269,10.76,160,84,22.4,very_deep,0.509,1118,332,1278,416,5
269,10.76,198,104,23.3,very_deep,0.502,1400,416,1598,520,5
269,10.76,238,123,19.7,deep,0.516,1680,500,1918,623,4
270,10.80,151,85,22.3,very_deep,0.522,1127,333,1278,418,5
270,10.80,188,105,22.3,very_deep,0.519,1410,417,1598,522,5
270,10.80,226,126,20.7,very_deep,0.533,1692,501,1918,627,5
271,10.84,150,79,19.1,deep,0.699,1128,338,1278,417,4
271,10.84,185,97,19.1,deep,0.687,1412,425,1597,522,4
271,10.84,222,119,19.3,deep,0.681,1695,508,1917,627,4
272,10.88,129,79,22.0,very_deep,0.592,1151,346,1280,425,5
272,10.88,156,98,21.1,very_deep,0.603,1442,433,1598,531,5
272,10.88,187,116,21.7,very_deep,0.611,1731,521,1918,637,5
273,10.92,120,78,21.0,very_deep,0.497,1158,347,1278,425,5
273,10.92,150,96,21.8,very_deep,0.528,1448,435,1598,531,5
273,10.92,180,116,21.4,very_deep,0.526,1738,522,1918,638,5
274,10.96,114,77,21.8,very_deep,0.557,1163,350,1277,427,5
274,10.96,144,96,23.4,very_deep,0.571,1453,437,1597,533,5
274,10.96,172,115,23.1,very_deep,0.563,1745,526,1917,641,5
275,11.00,266,138,17.9,deep,0.888,0,470,266,608,4
275,11.00,100,82,21.7,very_deep,0.373,1178,355,1278,437,5
275,11.00,333,174,16.8,deep,0.889,0,587,333,761,4
275,11.00,128,103,21.1,very_deep,0.362,1470,443,1598,546,5
275,11.00,400,207,17.9,deep,0.890,0,705,400,912,4
275,11.00,153,123,23.4,very_deep,0.383,1765,532,1918,655,5
276,11.04,253,145,17.6,deep,0.938,0,477,253,622,4
276,11.04,77,76,24.1,very_deep,0.587,1201,365,1278,441,5
276,11.04,318,181,16.3,deep,0.939,0,596,318,777,4
276,11.04,105,98,23.6,very_deep,0.556,1495,455,1600,553,5
276,11.04,381,216,17.7,deep,0.938,1,716,382,932,4
276,11.04,125,119,21.3,very_deep,0.550,1795,546,1920,665,5
277,11.08,250,155,17.0,deep,0.933,0,482,250,637,4
277,11.08,311,193,18.3,deep,0.934,0,603,311,796,4
277,11.08,90,100,26.3,critical,0.301,1508,460,1598,560,6
277,11.08,373,233,16.7,deep,0.935,0,723,373,956,4
277,11.08,110,120,22.7,very_deep,0.334,1808,552,1918,672,5
278,11.12,234,163,17.7,deep,0.923,2,508,236,671,4
278,11.12,293,202,19.4,deep,0.919,3,636,296,838,4
278,11.12,350,243,15.9,medium,0.921,5,763,355,1006,3
279,11.16,226,175,17.3,deep,0.908,5,512,231,687,4
279,11.16,284,217,19.0,deep,0.912,6,641,290,858,4
279,11.16,340,263,18.9,deep,0.912,7,768,347,1031,4
280,11.20,218,171,19.9,deep,0.914,2,527,220,698,4
280,11.20,274,215,17.4,deep,0.914,2,658,276,873,4
280,11.20,328,258,17.8,deep,0.914,3,790,331,1048,4
281,11.24,210,169,17.6,deep,0.889,1,541,211,710,4
281,11.24,262,211,18.8,deep,0.893,1,676,263,887,4
281,11.24,314,252,19.7,deep,0.888,2,811,316,1063,4
282,11.28,194,158,18.7,deep,0.904,1,562,195,720,4
282,11.28,242,197,17.8,deep,0.906,1,703,243,900,4
282,11.28,291,235,17.3,deep,0.907,1,845,292,1080,4
283,11.32,185,147,19.1,deep,0.927,0,573,185,720,4
283,11.32,232,183,18.5,deep,0.931,0,717,232,900,4
283,11.32,278,219,17.9,deep,0.931,0,861,278,1080,4
284,11.36,170,130,19.1,deep,0.879,0,590,170,720,4
284,11.36,212,162,17.0,deep,0.885,0,738,212,900,4
284,11.36,256,194,17.7,deep,0.887,0,886,256,1080,4
285,11.40,135,97,18.4,deep,0.808,1,623,136,720,4
285,11.40,168,120,19.2,deep,0.810,2,780,170,900,4
285,11.40,203,144,18.8,deep,0.808,2,936,205,1080,4
286,11.44,133,79,20.4,very_deep,0.739,0,641,133,720,5
286,11.44,167,98,21.0,very_deep,0.728,0,802,167,900,5
286,11.44,201,117,19.6,deep,0.725,0,963,201,1080,4
287,11.48,98,62,21.1,very_deep,0.693,0,658,98,720,5
287,11.48,123,77,18.6,deep,0.703,0,823,123,900,4
287,11.48,148,92,19.1,deep,0.705,0,988,148,1080,4
341,13.64,243,126,19.0,deep,0.853,197,545,440,671,4
341,13.64,300,156,17.6,deep,0.824,251,682,551,838,4
341,13.64,361,188,17.0,deep,0.841,300,818,661,1006,4
343,13.72,150,77,20.9,very_deep,0.702,1012,578,1162,655,5
343,13.72,246,123,18.5,deep,0.689,187,593,433,716,4
343,13.72,185,94,21.3,very_deep,0.702,1267,723,1452,817,5
343,13.72,222,114,18.4,deep,0.706,1520,867,1742,981,4
344,13.76,145,74,19.4,deep,0.589,1037,597,1182,671,4
344,13.76,177,93,21.7,very_deep,0.588,1300,747,1477,840,5
344,13.76,215,111,19.6,deep,0.580,1558,896,1773,1007,4
345,13.80,150,77,19.3,deep,0.692,1080,640,1230,717,4
345,13.80,188,96,19.4,deep,0.704,1350,800,1538,896,4
345,13.80,227,118,21.0,very_deep,0.708,1620,958,1847,1076,5
348,13.92,50,40,21.6,very_deep,0.370,0,193,50,233,5
348,13.92,62,50,25.5,critical,0.366,0,242,62,292,6
348,13.92,75,60,22.0,very_deep,0.353,0,290,75,350,5
349,13.96,48,42,22.3,very_deep,0.312,0,193,48,235,5
349,13.96,61,50,24.3,very_deep,0.325,0,242,61,292,5
349,13.96,72,60,22.5,very_deep,0.313,0,291,72,351,5
352,14.08,33,29,22.6,very_deep,0.368,0,201,33,230,5
352,14.08,41,35,24.7,very_deep,0.374,0,252,41,287,5
352,14.08,50,44,22.5,very_deep,0.372,0,302,50,346,5
353,14.12,32,28,26.3,critical,0.361,0,203,32,231,6
353,14.12,40,33,25.9,critical,0.381,0,255,40,288,6
353,14.12,48,40,24.9,very_deep,0.378,0,306,48,346,5
358,14.32,275,152,19.0,deep,0.552,1002,296,1277,448,4
358,14.32,344,191,21.2,very_deep,0.492,1252,371,1596,562,5
358,14.32,414,230,18.5,deep,0.510,1502,445,1916,675,4
359,14.36,267,157,22.4,very_deep,0.382,1010,298,1277,455,5
359,14.36,332,196,22.4,very_deep,0.349,1268,372,1600,568,5
359,14.36,397,236,20.3,very_deep,0.356,1523,446,1920,682,5
360,14.40,260,162,19.4,deep,0.637,1018,298,1278,460,4
360,14.40,323,200,18.4,deep,0.595,1275,375,1598,575,4
360,14.40,387,240,18.8,deep,0.594,1531,450,1918,690,4
361,14.44,257,161,21.2,very_deep,0.677,1023,302,1280,463,5
361,14.44,320,203,18.0,deep,0.651,1280,377,1600,580,4
361,14.44,385,243,17.8,deep,0.656,1535,452,1920,695,4
362,14.48,243,165,18.5,deep,0.661,1035,305,1278,470,4
362,14.48,308,206,17.7,deep,0.670,1292,381,1600,587,4
362,14.48,369,247,17.3,deep,0.654,1551,458,1920,705,4
363,14.52,240,162,18.9,deep,0.698,1040,313,1280,475,4
363,14.52,302,204,19.4,deep,0.707,1298,391,1600,595,4
363,14.52,362,243,18.4,deep,0.697,1558,470,1920,713,4
364,14.56,222,166,20.5,very_deep,0.682,1058,320,1280,486,5
364,14.56,278,207,20.8,very_deep,0.669,1322,400,1600,607,5
364,14.56,333,248,21.2,very_deep,0.677,1587,480,1920,728,5
365,14.60,209,162,21.7,very_deep,0.738,1071,326,1280,488,5
365,14.60,262,204,19.0,deep,0.746,1338,407,1600,611,4
365,14.60,253,130,21.4,very_deep,0.521,1153,605,1406,735,5
365,14.60,314,245,20.8,very_deep,0.747,1606,488,1920,733,5
365,14.60,307,157,21.1,very_deep,0.561,1383,725,1690,882,5
366,14.64,207,165,21.2,very_deep,0.731,1073,328,1280,493,5
366,14.64,189,101,20.8,very_deep,0.427,941,505,1130,606,5
366,14.64,257,206,20.1,very_deep,0.728,1343,411,1600,617,5
366,14.64,230,122,23.4,very_deep,0.444,1176,635,1406,757,5
366,14.64,308,247,20.8,very_deep,0.732,1612,493,1920,740,5
366,14.64,280,148,20.8,very_deep,0.438,1411,760,1691,908,5
367,14.68,198,167,20.8,very_deep,0.738,1082,331,1280,498,5
367,14.68,152,104,24.6,very_deep,0.332,961,518,1113,622,5
367,14.68,248,210,20.2,very_deep,0.731,1352,413,1600,623,5
367,14.68,183,130,19.8,deep,0.480,1202,648,1385,778,4
367,14.68,298,250,19.2,deep,0.731,1622,497,1920,747,4
367,14.68,221,156,21.2,very_deep,0.472,1442,777,1663,933,5
368,14.72,163,120,21.7,very_deep,0.728,988,547,1151,667,5
368,14.72,179,168,22.1,very_deep,0.630,1101,335,1280,503,5
368,14.72,203,152,18.1,deep,0.729,1235,683,1438,835,4
368,14.72,224,210,21.5,very_deep,0.641,1376,420,1600,630,5
368,14.72,245,180,19.2,deep,0.715,1481,821,1726,1001,4
368,14.72,268,253,19.6,deep,0.638,1652,503,1920,756,4
369,14.76,163,168,23.1,very_deep,0.606,1115,338,1278,506,5
369,14.76,174,124,22.0,very_deep,0.484,1002,557,1176,681,5
369,14.76,210,198,21.9,very_deep,0.623,1388,433,1598,631,5
369,14.76,214,154,21.8,very_deep,0.556,1253,697,1467,851,5
369,14.76,254,237,21.4,very_deep,0.630,1666,520,1920,757,5
369,14.76,257,185,22.0,very_deep,0.541,1505,836,1762,1021,5
370,14.80,159,163,19.6,deep,0.661,1121,350,1280,513,4
370,14.80,163,119,23.7,very_deep,0.503,1025,583,1188,702,5
370,14.80,198,205,19.1,deep,0.668,1402,437,1600,642,4
370,14.80,204,148,20.1,very_deep,0.513,1282,730,1486,878,5
370,14.80,237,246,18.6,deep,0.669,1683,525,1920,771,4
370,14.80,244,179,20.2,very_deep,0.524,1538,876,1782,1055,5
371,14.84,154,162,19.5,deep,0.678,1126,353,1280,515,4
371,14.84,193,202,19.4,deep,0.704,1407,441,1600,643,4
371,14.84,232,242,18.9,deep,0.705,1688,530,1920,772,4
372,14.88,133,152,21.8,very_deep,0.764,1147,358,1280,510,5
372,14.88,167,190,21.0,very_deep,0.766,1433,447,1600,637,5
372,14.88,199,228,21.2,very_deep,0.764,1721,537,1920,765,5
373,14.92,122,145,22.4,very_deep,0.733,1158,361,1280,506,5
373,14.92,152,180,20.5,very_deep,0.733,1448,452,1600,632,5
373,14.92,183,218,19.9,deep,0.739,1737,542,1920,760,4
374,14.96,120,142,22.2,very_deep,0.763,1160,366,1280,508,5
374,14.96,149,178,21.8,very_deep,0.753,1451,458,1600,636,5
374,14.96,179,213,19.8,deep,0.753,1741,550,1920,763,4
375,15.00,93,135,24.1,very_deep,0.492,1185,378,1278,513,5
375,15.00,117,169,22.3,very_deep,0.524,1481,473,1598,642,5
375,15.00,141,203,22.7,very_deep,0.528,1777,568,1918,771,5
376,15.04,85,132,25.1,critical,0.382,1195,383,1280,515,6
376,15.04,108,165,24.8,very_deep,0.373,1492,478,1600,643,5
376,15.04,129,197,24.8,very_deep,0.356,1791,575,1920,772,5
455,18.20,223,119,21.2,very_deep,0.615,3,371,226,490,5
455,18.20,278,147,19.9,deep,0.622,5,465,283,612,4
455,18.20,335,178,19.9,deep,0.691,6,557,341,735,4
456,18.24,225,126,17.9,deep,0.906,2,377,227,503,4
456,18.24,283,156,16.9,deep,0.898,3,472,286,628,4
456,18.24,340,186,16.3,deep,0.899,3,567,343,753,4
457,18.28,200,130,18.6,deep,0.825,0,381,200,511,4
457,18.28,251,161,18.9,deep,0.867,0,477,251,638,4
457,18.28,306,195,17.9,deep,0.870,0,572,306,767,4
458,18.32,196,140,20.1,very_deep,0.882,5,393,201,533,5
458,18.32,245,174,16.8,deep,0.882,6,492,251,666,4
458,18.32,295,209,19.6,deep,0.875,7,591,302,800,4
459,18.36,197,143,18.3,deep,0.899,3,400,200,543,4
459,18.36,246,180,19.3,deep,0.903,5,500,251,680,4
459,18.36,295,215,18.8,deep,0.909,6,600,301,815,4
460,18.40,172,150,19.1,deep,0.664,0,405,172,555,4
460,18.40,235,190,20.0,very_deep,0.771,0,505,235,695,5
460,18.40,282,227,19.7,deep,0.775,1,606,283,833,4
461,18.44,188,158,18.2,deep,0.859,0,412,188,570,4
461,18.44,102,51,18.9,deep,0.695,0,195,102,246,4
461,18.44,235,197,18.7,deep,0.861,1,515,236,712,4
461,18.44,282,237,19.9,deep,0.857,1,618,283,855,4
461,18.44,152,77,18.5,deep,0.702,0,293,152,370,4
462,18.48,168,180,17.0,deep,0.928,0,421,168,601,4
462,18.48,211,225,16.5,deep,0.928,0,526,211,751,4
462,18.48,253,270,19.7,deep,0.922,0,631,253,901,4
463,18.52,162,181,20.2,very_deep,0.941,0,430,162,611,5
463,18.52,205,225,17.0,deep,0.940,0,538,205,763,4
463,18.52,245,270,19.4,deep,0.940,0,646,245,916,4
464,18.56,152,190,18.9,deep,0.917,0,436,152,626,4
464,18.56,190,237,17.1,deep,0.915,0,545,190,782,4
464,18.56,227,285,19.2,deep,0.914,0,653,227,938,4
465,18.60,131,194,19.9,deep,0.777,0,457,131,651,4
465,18.60,83,46,22.4,very_deep,0.671,0,202,83,248,5
465,18.60,165,241,19.9,deep,0.779,0,572,165,813,4
465,18.60,103,58,22.7,very_deep,0.671,0,253,103,311,5
465,18.60,198,290,17.5,deep,0.784,0,687,198,977,4
465,18.60,123,70,19.6,deep,0.676,0,303,123,373,4
466,18.64,80,44,21.0,very_deep,0.670,0,203,80,247,5
466,18.64,118,181,21.9,very_deep,0.529,0,486,118,667,5
466,18.64,100,53,21.7,very_deep,0.667,0,255,100,308,5
466,18.64,146,225,21.9,very_deep,0.606,0,610,146,835,5
466,18.64,120,65,20.2,very_deep,0.666,0,306,120,371,5
466,18.64,175,271,20.9,very_deep,0.632,0,732,175,1003,5
467,18.68,78,43,22.5,very_deep,0.665,0,205,78,248,5
467,18.68,106,160,23.5,very_deep,0.572,0,517,106,677,5
467,18.68,100,55,22.7,very_deep,0.670,0,256,100,311,5
467,18.68,135,190,22.5,very_deep,0.515,0,653,135,843,5
467,18.68,120,65,20.6,very_deep,0.676,0,307,120,372,5
467,18.68,160,238,21.2,very_deep,0.535,0,778,160,1016,5
468,18.72,72,48,20.5,very_deep,0.634,0,205,72,253,5
468,18.72,91,61,22.3,very_deep,0.642,0,256,91,317,5
468,18.72,98,195,24.9,very_deep,0.475,0,686,98,881,5
468,18.72,108,74,22.4,very_deep,0.645,0,307,108,381,5
468,18.72,496,249,20.5,very_deep,0.587,1420,446,1916,695,5
468,18.72,118,230,21.6,very_deep,0.480,0,827,118,1057,5
469,18.76,68,48,23.3,very_deep,0.653,0,205,68,253,5
469,18.76,83,60,19.2,deep,0.639,0,256,83,316,4
469,18.76,101,73,20.0,very_deep,0.633,0,307,101,380,5
469,18.76,485,246,18.6,deep,0.580,1432,451,1917,697,4
470,18.80,66,48,21.1,very_deep,0.623,0,205,66,253,5
470,18.80,325,174,19.2,deep,0.486,952,292,1277,466,4
470,18.80,81,61,20.7,very_deep,0.619,0,256,81,317,5
470,18.80,409,219,20.0,very_deep,0.462,1188,363,1597,582,5
470,18.80,97,74,20.2,very_deep,0.623,0,307,97,381,5
470,18.80,491,261,21.2,very_deep,0.467,1426,437,1917,698,5
471,18.84,52,48,22.6,very_deep,0.616,0,205,52,253,5
471,18.84,322,178,22.9,very_deep,0.389,955,293,1277,471,5
471,18.84,67,61,22.8,very_deep,0.610,0,256,67,317,5
471,18.84,407,223,21.9,very_deep,0.359,1190,365,1597,588,5
471,18.84,81,74,23.2,very_deep,0.603,0,307,81,381,5
471,18.84,490,268,22.1,very_deep,0.369,1427,438,1917,706,5
472,18.88,50,50,22.6,very_deep,0.636,0,205,50,255,5
472,18.88,307,156,22.2,very_deep,0.400,971,320,1278,476,5
472,18.88,62,62,23.1,very_deep,0.627,0,256,62,318,5
472,18.88,385,197,19.6,deep,0.402,1213,398,1598,595,4
472,18.88,75,75,20.7,very_deep,0.625,0,307,75,382,5
472,18.88,461,235,21.9,very_deep,0.411,1456,478,1917,713,5
473,18.92,48,50,20.8,very_deep,0.593,0,205,48,255,5
473,18.92,300,163,21.8,very_deep,0.498,978,318,1278,481,5
473,18.92,62,62,23.8,very_deep,0.615,0,256,62,318,5
473,18.92,373,204,20.8,very_deep,0.446,1225,398,1598,602,5
473,18.92,75,74,22.2,very_deep,0.621,0,308,75,382,5
473,18.92,446,245,19.3,deep,0.462,1471,478,1917,723,4
474,18.96,292,156,20.0,deep,0.578,986,325,1278,481,4
474,18.96,45,50,22.1,very_deep,0.567,0,205,45,255,5
474,18.96,57,62,20.7,very_deep,0.568,0,256,57,318,5
474,18.96,365,195,19.7,deep,0.560,1233,406,1598,601,4
474,18.96,68,75,23.6,very_deep,0.575,0,307,68,382,5
474,18.96,440,233,20.3,very_deep,0.553,1478,488,1918,721,5
475,19.00,302,158,17.9,deep,0.727,976,328,1278,486,4
475,19.00,38,48,20.3,very_deep,0.614,0,208,38,256,5
475,19.00,380,197,20.6,very_deep,0.678,1218,410,1598,607,5
475,19.00,47,59,23.8,very_deep,0.611,0,261,47,320,5
475,19.00,456,238,18.8,deep,0.704,1462,492,1918,730,4
475,19.00,57,70,22.7,very_deep,0.609,0,313,57,383,5
476,19.04,297,160,18.6,deep,0.721,981,328,1278,488,4
476,19.04,36,45,23.4,very_deep,0.538,0,211,36,256,5
476,19.04,371,201,18.7,deep,0.711,1227,410,1598,611,4
476,19.04,46,56,23.5,very_deep,0.567,0,265,46,321,5
476,19.04,446,241,17.5,deep,0.714,1472,492,1918,733,4
476,19.04,55,68,21.7,very_deep,0.572,0,317,55,385,5
477,19.08,277,164,20.5,very_deep,0.638,1001,328,1278,492,5
477,19.08,33,44,24.7,very_deep,0.537,0,211,33,255,5
477,19.08,348,203,17.7,deep,0.616,1250,410,1598,613,4
477,19.08,41,53,22.8,very_deep,0.534,0,265,41,318,5
477,19.08,418,244,19.1,deep,0.630,1500,493,1918,737,4
477,19.08,50,66,21.1,very_deep,0.542,0,317,50,383,5
478,19.12,25,41,25.8,critical,0.393,0,215,25,256,6
478,19.12,254,172,20.2,very_deep,0.347,1023,323,1277,495,5
478,19.12,30,48,24.3,very_deep,0.393,0,270,30,318,5
478,19.12,314,213,21.4,very_deep,0.324,1283,405,1597,618,5
478,19.12,36,60,25.2,critical,0.387,0,323,36,383,6
478,19.12,375,256,20.8,very_deep,0.362,1542,486,1917,742,5
482,19.28,233,167,21.0,very_deep,0.465,1045,356,1278,523,5
482,19.28,285,210,20.4,very_deep,0.464,1313,445,1598,655,5
482,19.28,341,253,19.4,deep,0.465,1576,533,1917,786,4
486,19.44,178,166,23.9,very_deep,0.327,1102,386,1280,552,5
486,19.44,219,209,25.2,critical,0.308,1381,482,1600,691,6
498,19.92,289,165,22.0,very_deep,0.329,38,696,327,861,5
498,19.92,346,196,20.9,very_deep,0.322,47,836,393,1032,5
499,19.96,250,142,23.9,very_deep,0.376,6,570,256,712,5
499,19.96,312,174,21.7,very_deep,0.501,8,717,320,891,5
499,19.96,375,212,20.5,very_deep,0.463,10,858,385,1070,5
500,20.00,242,135,22.1,very_deep,0.528,0,585,242,720,5
500,20.00,302,168,17.9,deep,0.627,0,732,302,900,4
500,20.00,363,202,19.8,deep,0.596,0,878,363,1080,4
534,21.36,252,126,19.7,deep,0.426,0,587,252,713,4
534,21.36,318,159,22.8,very_deep,0.431,0,733,318,892,5
580,23.20,225,118,21.1,very_deep,0.315,1053,258,1278,376,5
581,23.24,216,120,20.5,very_deep,0.399,1062,258,1278,378,5
581,23.24,268,150,21.0,very_deep,0.380,1330,323,1598,473,5
581,23.24,322,180,21.7,very_deep,0.388,1596,388,1918,568,5
582,23.28,302,181,23.0,very_deep,0.300,1618,392,1920,573,5
619,24.76,119,60,25.5,critical,0.303,916,431,1035,491,6
619,24.76,177,90,22.9,very_deep,0.332,1375,647,1552,737,5
620,24.80,127,67,22.1,very_deep,0.417,930,436,1057,503,5
620,24.80,160,85,24.2,very_deep,0.400,1161,543,1321,628,5
620,24.80,192,103,24.1,very_deep,0.399,1393,652,1585,755,5
623,24.92,145,76,21.0,very_deep,0.430,976,480,1121,556,5
623,24.92,185,96,23.4,very_deep,0.448,1217,600,1402,696,5
623,24.92,220,115,23.1,very_deep,0.427,1462,720,1682,835,5
624,24.96,147,89,20.2,very_deep,0.683,985,483,1132,572,5
624,24.96,185,110,20.5,very_deep,0.687,1231,605,1416,715,5
624,24.96,223,132,19.1,deep,0.700,1477,726,1700,858,4
625,25.00,172,101,21.6,very_deep,0.305,1003,506,1175,607,5
625,25.00,231,227,21.1,very_deep,0.310,0,653,231,880,5
627,25.08,187,115,21.1,very_deep,0.666,1035,526,1222,641,5
627,25.08,235,144,19.3,deep,0.634,1293,657,1528,801,4
627,25.08,281,171,20.1,very_deep,0.641,1552,790,1833,961,5
628,25.12,188,128,23.2,very_deep,0.430,1068,553,1256,681,5
628,25.12,232,158,23.4,very_deep,0.388,1335,692,1567,850,5
628,25.12,278,189,23.0,very_deep,0.404,1602,831,1880,1020,5
644,25.76,90,45,24.9,very_deep,0.333,597,255,687,300,5
645,25.80,95,53,23.5,very_deep,0.398,595,252,690,305,5
645,25.80,120,64,24.4,very_deep,0.435,743,317,863,381,5
645,25.80,142,76,23.6,very_deep,0.428,893,381,1035,457,5
646,25.84,117,60,21.7,very_deep,0.384,746,322,863,382,5
646,25.84,142,72,24.0,very_deep,0.382,895,386,1037,458,5
647,25.88,121,68,21.2,very_deep,0.330,746,317,867,385,5
647,25.88,146,80,22.2,very_deep,0.336,895,381,1041,461,5
654,26.16,158,80,22.0,very_deep,0.525,1120,372,1278,452,5
654,26.16,200,100,22.3,very_deep,0.543,1398,466,1598,566,5
654,26.16,238,120,22.5,very_deep,0.541,1680,560,1918,680,5
655,26.20,127,89,20.5,very_deep,0.647,1151,386,1278,475,5
655,26.20,158,110,21.7,very_deep,0.671,1440,482,1598,592,5
655,26.20,191,132,22.2,very_deep,0.678,1727,578,1918,710,5
656,26.24,122,95,21.4,very_deep,0.658,1156,388,1278,483,5
656,26.24,153,118,20.1,very_deep,0.647,1445,487,1598,605,5
656,26.24,183,140,18.6,deep,0.652,1735,585,1918,725,4
661,26.44,125,66,23.5,very_deep,0.448,615,342,740,408,5
675,27.00,230,118,19.7,deep,0.867,663,528,893,646,4
675,27.00,128,64,21.1,very_deep,0.660,650,418,778,482,5
675,27.00,290,149,19.1,deep,0.872,828,661,1118,810,4
675,27.00,156,79,20.2,very_deep,0.707,815,523,971,602,5
675,27.00,347,178,16.1,deep,0.871,995,793,1342,971,4
675,27.00,188,95,20.1,very_deep,0.712,977,628,1165,723,5
676,27.04,224,126,18.5,deep,0.898,673,542,897,668,4
676,27.04,279,156,18.8,deep,0.901,842,677,1121,833,4
676,27.04,335,188,16.2,deep,0.900,1011,813,1346,1001,4
677,27.08,230,125,16.2,deep,0.928,673,558,903,683,4
677,27.08,288,157,17.0,deep,0.928,842,698,1130,855,4
677,27.08,345,188,17.9,deep,0.928,1011,838,1356,1026,4
678,27.12,190,115,20.4,very_deep,0.878,681,597,871,712,5
678,27.12,237,144,16.6,deep,0.876,851,747,1088,891,4
678,27.12,169,85,22.9,very_deep,0.545,847,576,1016,661,5
678,27.12,285,174,17.0,deep,0.881,1022,896,1307,1070,4
678,27.12,202,101,19.1,deep,0.557,1016,692,1218,793,4
679,27.16,215,108,18.9,deep,0.739,1013,707,1228,815,4
680,27.20,145,75,20.8,very_deep,0.773,678,482,823,557,5
680,27.20,180,95,20.1,very_deep,0.807,848,602,1028,697,5
680,27.20,217,113,20.3,very_deep,0.814,1018,723,1235,836,5
681,27.24,147,80,19.6,deep,0.754,685,498,832,578,4
681,27.24,92,48,22.6,very_deep,0.461,705,670,797,718,5
681,27.24,185,100,21.1,very_deep,0.761,856,623,1041,723,5
681,27.24,114,61,21.6,very_deep,0.487,881,837,995,898,5
681,27.24,223,122,18.8,deep,0.749,1027,748,1250,870,4
681,27.24,136,72,23.0,very_deep,0.485,1057,1006,1193,1078,5
682,27.28,145,90,20.9,very_deep,0.656,696,528,841,618,5
682,27.28,181,111,18.5,deep,0.681,871,661,1052,772,4
682,27.28,216,133,22.1,very_deep,0.652,1046,793,1262,926,5
683,27.32,145,93,18.1,deep,0.895,706,543,851,636,4
683,27.32,180,115,20.4,very_deep,0.887,883,680,1063,795,5
683,27.32,216,136,18.3,deep,0.887,1060,816,1276,952,4
684,27.36,160,97,18.1,deep,0.787,707,563,867,660,4
684,27.36,197,118,18.8,deep,0.786,886,705,1083,823,4
684,27.36,239,144,20.8,very_deep,0.801,1062,846,1301,990,5
685,27.40,168,95,21.1,very_deep,0.800,722,603,890,698,5
685,27.40,209,118,17.7,deep,0.802,903,755,1112,873,4
685,27.40,250,142,19.6,deep,0.803,1085,906,1335,1048,4
688,27.52,78,45,21.6,very_deep,0.309,1202,401,1280,446,5
689,27.56,58,47,21.8,very_deep,0.460,1220,410,1278,457,5
689,27.56,73,60,25.2,critical,0.416,1525,512,1598,572,6
689,27.56,88,70,22.0,very_deep,0.435,1830,616,1918,686,5
