Frame,Timestamp,Width_px,Height_px,Depth_cm,Category,Confidence,X1,Y1,X2,Y2,Priority
3,0.12,144,73,19.2,deep,0.814,342,350,486,423,4
4,0.16,147,76,19.3,deep,0.800,338,351,485,427,4
8,0.32,161,83,19.3,deep,0.795,322,377,483,460,4
9,0.36,163,85,19.1,deep,0.829,320,381,483,466,4
10,0.40,171,90,18.5,deep,0.898,313,384,484,474,4
11,0.44,172,92,18.3,deep,0.920,313,385,485,477,4
12,0.48,167,96,18.4,deep,0.925,306,395,473,491,4
13,0.52,168,96,18.6,deep,0.895,304,403,472,499,4
14,0.56,184,106,18.5,deep,0.897,296,403,480,509,4
15,0.60,194,104,18.0,deep,0.955,281,414,475,518,4
16,0.64,193,116,18.0,deep,0.970,275,416,468,532,4
17,0.68,189,121,18.3,deep,0.939,273,423,462,544,4
18,0.72,196,119,18.7,deep,0.876,264,437,460,556,4
19,0.76,200,131,18.3,deep,0.931,260,440,460,571,4
20,0.80,220,136,18.0,deep,0.949,242,446,462,582,4
21,0.84,229,142,17.9,deep,0.949,232,450,461,592,4
22,0.88,242,146,18.0,deep,0.926,218,467,460,613,4
23,0.92,244,152,18.0,deep,0.926,214,472,458,624,4
24,0.96,250,159,17.8,deep,0.952,201,480,451,639,4
25,1.00,257,172,18.3,deep,0.880,183,493,440,665,4
26,1.04,270,175,18.1,deep,0.896,171,498,441,673,4
27,1.08,278,175,18.0,deep,0.901,158,512,436,687,4
28,1.12,289,203,18.0,deep,0.902,144,517,433,720,4
29,1.16,284,179,18.1,deep,0.885,137,541,421,720,4
29,1.16,85,48,23.5,very_deep,0.320,770,396,855,444,5
30,1.20,276,174,18.0,deep,0.900,130,546,406,720,4
31,1.24,272,159,18.1,deep,0.895,121,561,393,720,4
32,1.28,263,140,18.0,deep,0.907,111,580,374,720,4
33,1.32,92,54,22.1,very_deep,0.495,784,422,876,476,5
34,1.36,95,53,23.3,very_deep,0.328,786,428,881,481,5
35,1.40,101,53,22.8,very_deep,0.389,787,444,888,497,5
39,1.56,112,61,22.1,very_deep,0.473,805,476,917,537,5
40,1.60,103,64,23.0,very_deep,0.389,812,483,915,547,5
41,1.64,112,71,23.4,very_deep,0.324,816,486,928,557,5
42,1.68,115,68,21.9,very_deep,0.507,820,510,935,578,5
43,1.72,115,75,23.1,very_deep,0.371,834,514,949,589,5
45,1.80,128,78,21.4,very_deep,0.571,845,542,973,620,5
46,1.84,128,85,22.5,very_deep,0.434,848,550,976,635,5
47,1.88,128,83,22.6,very_deep,0.428,858,560,986,643,5
48,1.92,127,95,20.9,very_deep,0.652,874,578,1001,673,5
51,2.04,597,304,18.4,deep,0.480,6,378,603,682,4
54,2.16,182,92,18.1,deep,0.936,0,320,182,412,4
55,2.20,169,98,18.5,deep,0.915,0,323,169,421,4
56,2.24,166,101,18.7,deep,0.899,0,328,166,429,4
57,2.28,166,104,18.8,deep,0.888,0,333,166,437,4
58,2.32,171,87,18.7,deep,0.869,995,451,1166,538,4
58,2.32,162,102,18.9,deep,0.868,0,344,162,446,4
59,2.36,149,107,18.7,deep,0.917,0,345,149,452,4
60,2.40,140,108,18.8,deep,0.918,0,349,140,457,4
61,2.44,139,107,18.8,deep,0.915,0,355,139,462,4
61,2.44,180,91,18.8,deep,0.853,1018,479,1198,570,4
62,2.48,177,93,18.5,deep,0.900,1042,492,1219,585,4
62,2.48,132,115,19.5,deep,0.843,0,364,132,479,4
63,2.52,183,106,19.1,deep,0.817,1051,501,1234,607,4
63,2.52,120,112,20.3,very_deep,0.752,0,371,120,483,5
64,2.56,185,104,18.5,deep,0.899,1059,511,1244,615,4
64,2.56,118,112,19.6,deep,0.844,0,377,118,489,4
64,2.56,97,51,20.0,very_deep,0.743,695,322,792,373,5
65,2.60,195,114,18.6,deep,0.877,1083,532,1278,646,4
66,2.64,186,123,18.6,deep,0.897,1092,549,1278,672,4
66,2.64,93,88,22.7,very_deep,0.479,0,396,93,484,5
66,2.64,105,139,23.5,very_deep,0.379,265,471,370,610,5
67,2.68,172,130,18.9,deep,0.884,1105,554,1277,684,4
67,2.68,77,91,23.2,very_deep,0.448,0,402,77,493,5
67,2.68,107,137,22.9,very_deep,0.447,259,479,366,616,5
68,2.72,153,133,19.1,deep,0.879,1126,582,1279,715,4
69,2.76,136,120,20.3,very_deep,0.740,1144,593,1280,713,5
69,2.76,48,55,24.5,very_deep,0.303,0,416,48,471,5
70,2.80,116,105,19.4,deep,0.868,1161,614,1277,719,4
71,2.84,99,92,20.9,very_deep,0.700,1178,626,1277,718,5
72,2.88,66,51,22.0,very_deep,0.561,1213,669,1279,720,5
78,3.12,211,127,19.9,deep,0.700,1068,492,1279,619,4
79,3.16,203,144,19.7,deep,0.747,1077,497,1280,641,4
80,3.20,200,141,20.1,very_deep,0.700,1079,509,1279,650,5
81,3.24,183,145,20.3,very_deep,0.698,1096,515,1279,660,5
82,3.28,166,144,20.4,very_deep,0.703,1114,535,1280,679,5
83,3.32,166,84,18.9,deep,0.849,750,454,916,538,4
83,3.32,150,129,20.5,very_deep,0.700,1129,552,1279,681,5
84,3.36,149,142,21.3,very_deep,0.609,1131,551,1280,693,5
85,3.40,170,89,18.6,deep,0.886,764,482,934,571,4
85,3.40,300,155,18.8,deep,0.760,979,302,1279,457,4
85,3.40,123,121,23.7,very_deep,0.330,1156,579,1279,700,5
86,3.44,171,87,18.3,deep,0.919,772,486,943,573,4
86,3.44,295,158,19.5,deep,0.675,984,303,1279,461,4
86,3.44,106,127,23.4,very_deep,0.386,1173,585,1279,712,5
87,3.48,177,92,18.8,deep,0.851,774,494,951,586,4
87,3.48,292,161,19.2,deep,0.716,987,302,1279,463,4
88,3.52,185,98,18.2,deep,0.926,781,511,966,609,4
88,3.52,285,154,19.7,deep,0.656,995,312,1280,466,4
89,3.56,192,109,18.4,deep,0.913,788,518,980,627,4
89,3.56,276,154,20.4,very_deep,0.574,1003,316,1279,470,5
90,3.60,201,111,18.6,deep,0.874,793,528,994,639,4
90,3.60,270,151,20.5,very_deep,0.565,1010,321,1280,472,5
91,3.64,212,108,18.1,deep,0.924,790,542,1002,650,4
91,3.64,259,150,19.9,deep,0.655,1020,325,1279,475,4
91,3.64,70,44,23.7,very_deep,0.319,1210,530,1280,574,5
92,3.68,208,112,18.2,deep,0.918,805,566,1013,678,4
92,3.68,254,151,19.9,deep,0.665,1025,328,1279,479,4
92,3.68,45,40,23.7,very_deep,0.387,1235,552,1280,592,5
93,3.72,220,127,18.0,deep,0.936,811,576,1031,703,4
93,3.72,253,158,20.2,very_deep,0.627,1027,332,1280,490,5
93,3.72,135,75,23.3,very_deep,0.305,1,592,136,667,5
94,3.76,223,119,18.0,deep,0.928,809,591,1032,710,4
94,3.76,252,160,20.0,deep,0.660,1028,332,1280,492,4
95,3.80,305,153,18.4,deep,0.810,0,387,305,540,4
95,3.80,230,164,20.6,very_deep,0.607,1050,332,1280,496,5
96,3.84,306,161,18.7,deep,0.765,0,391,306,552,4
96,3.84,226,166,21.0,very_deep,0.560,1054,334,1280,500,5
97,3.88,301,164,18.9,deep,0.757,0,397,301,561,4
97,3.88,84,42,19.9,deep,0.756,758,321,842,363,4
97,3.88,215,165,21.4,very_deep,0.516,1065,341,1280,506,5
98,3.92,286,180,18.5,deep,0.830,0,402,286,582,4
98,3.92,201,145,21.0,very_deep,0.581,1078,356,1279,501,5
99,3.96,281,194,18.6,deep,0.821,0,405,281,599,4
99,3.96,198,147,20.5,very_deep,0.647,1081,358,1279,505,5
100,4.00,280,198,18.7,deep,0.816,0,411,280,609,4
100,4.00,88,44,20.0,very_deep,0.744,769,335,857,379,5
100,4.00,195,153,20.2,very_deep,0.698,1084,360,1279,513,5
101,4.04,276,193,18.7,deep,0.812,0,422,276,615,4
101,4.04,182,155,20.4,very_deep,0.683,1097,362,1279,517,5
102,4.08,260,209,18.4,deep,0.875,4,433,264,642,4
102,4.08,168,154,20.7,very_deep,0.666,1112,364,1280,518,5
103,4.12,265,217,18.5,deep,0.851,0,438,265,655,4
103,4.12,164,151,20.3,very_deep,0.712,1116,370,1280,521,5
104,4.16,253,227,18.4,deep,0.884,3,443,256,670,4
104,4.16,155,140,20.9,very_deep,0.648,1125,382,1280,522,5
105,4.20,236,238,18.4,deep,0.894,5,460,241,698,4
105,4.20,136,138,20.8,very_deep,0.686,1144,389,1280,527,5
106,4.24,233,245,18.3,deep,0.914,4,468,237,713,4
106,4.24,125,140,20.2,very_deep,0.767,1155,393,1280,533,5
107,4.28,230,244,18.3,deep,0.909,5,476,235,720,4
107,4.28,120,146,20.7,very_deep,0.718,1160,398,1280,544,5
108,4.32,215,230,18.3,deep,0.925,4,490,219,720,4
108,4.32,98,142,22.0,very_deep,0.577,1181,402,1279,544,5
109,4.36,212,219,18.6,deep,0.896,3,501,215,720,4
109,4.36,103,52,19.1,deep,0.853,816,386,919,438,4
109,4.36,95,108,23.1,very_deep,0.438,1184,414,1279,522,5
110,4.40,204,211,18.7,deep,0.886,0,509,204,720,4
110,4.40,81,105,23.1,very_deep,0.454,1199,417,1280,522,5
111,4.44,202,204,19.7,deep,0.754,0,516,202,720,4
111,4.44,63,98,23.9,very_deep,0.387,1215,425,1278,523,5
112,4.48,107,59,19.2,deep,0.854,840,404,947,463,4
112,4.48,178,176,20.7,very_deep,0.655,0,544,178,720,5
113,4.52,116,58,20.3,very_deep,0.688,838,411,954,469,5
114,4.56,116,62,20.0,deep,0.745,846,415,962,477,4
115,4.60,121,70,20.6,very_deep,0.673,858,425,979,495,5
115,4.60,136,116,22.4,very_deep,0.475,1,603,137,719,5
116,4.64,92,46,19.4,deep,0.816,802,367,894,413,4
116,4.64,120,69,19.9,deep,0.762,869,431,989,500,4
117,4.68,132,71,20.0,deep,0.732,868,437,1000,508,4
117,4.68,122,86,21.7,very_deep,0.554,1,634,123,720,5
118,4.72,139,77,20.3,very_deep,0.697,878,448,1017,525,5
119,4.76,138,86,20.0,deep,0.749,890,452,1028,538,4
120,4.80,99,50,19.8,deep,0.768,822,390,921,440,4
120,4.80,135,81,20.5,very_deep,0.683,898,462,1033,543,5
121,4.84,147,87,21.3,very_deep,0.559,897,467,1044,554,5
122,4.88,149,96,19.1,deep,0.853,916,481,1065,577,4
122,4.88,424,257,20.1,very_deep,0.451,0,463,424,720,5
123,4.92,152,97,19.8,deep,0.769,922,490,1074,587,4
123,4.92,427,214,20.2,very_deep,0.436,0,483,427,697,5
124,4.96,106,53,19.5,deep,0.796,846,419,952,472,4
124,4.96,164,105,20.3,very_deep,0.690,926,496,1090,601,5
124,4.96,416,220,20.4,very_deep,0.419,0,497,416,717,5
125,5.00,173,111,18.7,deep,0.900,941,513,1114,624,4
126,5.04,114,58,19.8,deep,0.764,860,437,974,495,4
126,5.04,176,121,19.7,deep,0.764,949,522,1125,643,4
127,5.08,180,121,19.0,deep,0.860,959,532,1139,653,4
128,5.12,197,132,18.7,deep,0.877,970,555,1167,687,4
128,5.12,132,69,19.9,deep,0.743,865,452,997,521,4
129,5.16,212,143,18.6,deep,0.883,973,561,1185,704,4
130,5.20,200,136,18.5,deep,0.908,995,576,1195,712,4
131,5.24,220,130,18.5,deep,0.879,998,588,1218,718,4
134,5.36,155,81,19.2,deep,0.814,902,512,1057,593,4
135,5.40,170,86,19.2,deep,0.796,904,532,1074,618,4
136,5.44,156,93,18.8,deep,0.884,934,542,1090,635,4
137,5.48,156,95,18.8,deep,0.885,942,552,1098,647,4
138,5.52,182,102,18.6,deep,0.890,942,574,1124,676,4
139,5.56,187,115,19.0,deep,0.836,948,584,1135,699,4
140,5.60,174,113,18.9,deep,0.872,980,595,1154,708,4
141,5.64,176,104,18.6,deep,0.893,986,612,1162,716,4
145,5.80,61,31,23.2,very_deep,0.349,860,351,921,382,5
147,5.88,298,152,18.3,deep,0.830,0,447,298,599,4
148,5.92,296,151,18.5,deep,0.807,0,463,296,614,4
149,5.96,283,160,18.9,deep,0.774,0,470,283,630,4
150,6.00,280,162,18.5,deep,0.828,0,479,280,641,4
151,6.04,280,174,18.9,deep,0.776,1,483,281,657,4
152,6.08,263,173,18.7,deep,0.821,0,503,263,676,4
153,6.12,254,180,18.8,deep,0.822,0,511,254,691,4
153,6.12,69,36,21.6,very_deep,0.560,913,400,982,436,5
154,6.16,247,186,18.7,deep,0.841,2,518,249,704,4
155,6.20,225,173,19.0,deep,0.821,2,545,227,718,4
155,6.20,70,39,22.8,very_deep,0.414,933,417,1003,456,5
156,6.24,213,163,19.5,deep,0.770,1,557,214,720,4
156,6.24,77,40,20.5,very_deep,0.698,936,422,1013,462,5
157,6.28,198,148,19.3,deep,0.804,0,572,198,720,4
158,6.32,165,120,20.0,very_deep,0.737,1,596,166,716,5
158,6.32,82,41,22.6,very_deep,0.415,955,444,1037,485,5
159,6.36,130,107,20.6,very_deep,0.704,0,611,130,718,5
159,6.36,82,44,22.8,very_deep,0.399,962,451,1044,495,5
160,6.40,101,90,21.9,very_deep,0.566,0,627,101,717,5
160,6.40,87,47,23.3,very_deep,0.334,966,457,1053,504,5
161,6.44,89,45,22.2,very_deep,0.458,976,467,1065,512,5
162,6.48,85,48,23.4,very_deep,0.330,995,484,1080,532,5
163,6.52,90,49,22.5,very_deep,0.434,1004,492,1094,541,5
164,6.56,91,49,22.6,very_deep,0.416,1013,501,1104,550,5
165,6.60,90,53,22.8,very_deep,0.417,1038,522,1128,575,5
168,6.72,263,133,19.4,deep,0.700,1015,261,1278,394,4
170,6.80,261,135,19.9,deep,0.648,1017,265,1278,400,4
170,6.80,312,158,20.7,very_deep,0.485,64,545,376,703,5
171,6.84,259,139,19.9,deep,0.644,1019,268,1278,407,4
171,6.84,313,164,21.9,very_deep,0.321,47,551,360,715,5
172,6.88,253,142,20.0,deep,0.647,1026,272,1279,414,4
173,6.92,247,140,19.8,deep,0.681,1031,274,1278,414,4
173,6.92,189,97,20.2,very_deep,0.662,226,563,415,660,5
174,6.96,213,109,19.7,deep,0.712,209,566,422,675,4
174,6.96,245,141,20.0,deep,0.660,1034,276,1279,417,4
175,7.00,234,134,20.0,very_deep,0.659,1045,283,1279,417,5
176,7.04,227,131,19.8,deep,0.700,1052,286,1279,417,4
177,7.08,222,134,19.7,deep,0.714,1057,288,1279,422,4
178,7.12,213,137,19.5,deep,0.758,1066,289,1279,426,4
179,7.16,318,167,17.7,deep,0.891,74,440,392,607,4
179,7.16,204,136,20.0,deep,0.708,1075,290,1279,426,4
180,7.20,313,173,18.2,deep,0.842,73,445,386,618,4
180,7.20,202,136,20.5,very_deep,0.646,1077,292,1279,428,5
181,7.24,329,182,18.5,deep,0.782,51,450,380,632,4
181,7.24,199,134,20.6,very_deep,0.630,1080,293,1279,427,5
182,7.28,191,125,20.7,very_deep,0.615,1088,302,1279,427,5
182,7.28,324,207,20.1,very_deep,0.568,34,461,358,668,5
182,7.28,63,44,22.7,very_deep,0.464,0,206,63,250,5
183,7.32,359,203,18.8,deep,0.713,17,476,376,679,4
183,7.32,183,125,20.9,very_deep,0.605,1096,301,1279,426,5
183,7.32,61,45,22.4,very_deep,0.510,0,207,61,252,5
184,7.36,335,221,19.0,deep,0.717,2,476,337,697,4
184,7.36,180,121,21.5,very_deep,0.530,1099,304,1279,425,5
184,7.36,56,35,22.7,very_deep,0.459,0,212,56,247,5
185,7.40,361,221,19.3,deep,0.646,0,499,361,720,4
185,7.40,171,112,21.6,very_deep,0.523,1108,312,1279,424,5
185,7.40,48,33,22.8,very_deep,0.459,0,215,48,248,5
186,7.44,321,216,19.9,deep,0.600,0,504,321,720,4
186,7.44,169,105,21.7,very_deep,0.507,1110,317,1279,422,5
186,7.44,49,34,23.3,very_deep,0.405,0,215,49,249,5
187,7.48,163,100,20.8,very_deep,0.625,1116,318,1279,418,5
187,7.48,311,205,20.2,very_deep,0.576,0,515,311,720,5
187,7.48,37,32,24.0,very_deep,0.346,0,218,37,250,5
188,7.52,149,80,20.3,very_deep,0.675,1130,321,1279,401,5
188,7.52,118,59,21.6,very_deep,0.524,655,430,773,489,5
188,7.52,261,178,21.1,very_deep,0.504,0,542,261,720,5
188,7.52,33,29,22.9,very_deep,0.491,0,221,33,250,5
189,7.56,136,79,20.5,very_deep,0.672,1143,322,1279,401,5
189,7.56,123,67,20.8,very_deep,0.635,659,433,782,500,5
189,7.56,229,170,21.3,very_deep,0.517,3,550,232,720,5
189,7.56,30,31,23.5,very_deep,0.435,0,220,30,251,5
190,7.60,128,78,20.2,very_deep,0.722,1151,324,1279,402,5
190,7.60,26,32,23.1,very_deep,0.497,0,221,26,253,5
190,7.60,225,156,22.0,very_deep,0.427,2,564,227,720,5
191,7.64,217,142,20.0,very_deep,0.689,3,578,220,720,5
191,7.64,124,78,20.6,very_deep,0.674,1155,326,1279,404,5
191,7.64,113,71,21.0,very_deep,0.638,666,450,779,521,5
192,7.68,136,73,20.1,very_deep,0.712,668,469,804,542,5
192,7.68,115,61,21.3,very_deep,0.574,1164,336,1279,397,5
193,7.72,138,74,19.7,deep,0.771,672,479,810,553,4
193,7.72,98,73,21.9,very_deep,0.553,1182,336,1280,409,5
193,7.72,176,93,23.0,very_deep,0.308,1,626,177,719,5
194,7.76,131,82,19.4,deep,0.826,676,482,807,564,4
194,7.76,95,57,22.7,very_deep,0.429,1184,341,1279,398,5
195,7.80,146,81,19.4,deep,0.801,683,507,829,588,4
195,7.80,81,51,22.9,very_deep,0.420,1199,346,1280,397,5
196,7.84,153,94,18.8,deep,0.884,685,512,838,606,4
196,7.84,70,46,22.2,very_deep,0.513,1210,348,1280,394,5
197,7.88,152,95,19.3,deep,0.830,686,523,838,618,4
197,7.88,65,50,22.7,very_deep,0.481,1215,349,1280,399,5
198,7.92,151,100,18.6,deep,0.921,697,546,848,646,4
199,7.96,158,123,18.9,deep,0.900,699,552,857,675,4
200,8.00,164,100,18.6,deep,0.914,705,576,869,676,4
201,8.04,161,114,18.5,deep,0.931,709,578,870,692,4
202,8.08,169,106,19.1,deep,0.840,716,607,885,713,4
240,9.60,71,36,23.2,very_deep,0.338,1207,353,1278,389,5
259,10.36,133,67,19.9,deep,0.733,1147,516,1280,583,4
260,10.40,116,62,22.5,very_deep,0.414,1163,529,1279,591,5
261,10.44,107,71,22.3,very_deep,0.479,1172,532,1279,603,5
262,10.48,71,58,22.4,very_deep,0.521,1209,560,1280,618,5
269,10.76,159,83,21.6,very_deep,0.502,1120,333,1279,416,5
270,10.80,151,84,21.6,very_deep,0.519,1128,334,1279,418,5
271,10.84,148,78,20.2,very_deep,0.687,1130,340,1278,418,5
272,10.88,125,78,21.2,very_deep,0.603,1154,347,1279,425,5
273,10.92,120,77,21.8,very_deep,0.528,1159,348,1279,425,5
274,10.96,115,77,21.6,very_deep,0.571,1163,350,1278,427,5
275,11.00,267,139,18.1,deep,0.889,0,470,267,609,4
275,11.00,103,82,23.4,very_deep,0.362,1176,355,1279,437,5
276,11.04,255,145,17.8,deep,0.939,0,477,255,622,4
276,11.04,84,79,22.1,very_deep,0.556,1196,364,1280,443,5
277,11.08,249,154,17.9,deep,0.934,0,483,249,637,4
277,11.08,72,80,24.3,very_deep,0.301,1207,368,1279,448,5
278,11.12,234,162,18.2,deep,0.919,3,509,237,671,4
279,11.16,227,174,18.3,deep,0.912,5,513,232,687,4
280,11.20,219,172,18.4,deep,0.914,2,527,221,699,4
281,11.24,210,169,18.6,deep,0.893,1,541,211,710,4
282,11.28,194,157,18.6,deep,0.906,1,563,195,720,4
283,11.32,186,146,18.5,deep,0.931,0,574,186,720,4
284,11.36,170,129,18.9,deep,0.885,0,591,170,720,4
285,11.40,134,96,19.6,deep,0.810,2,624,136,720,4
286,11.44,134,78,20.1,very_deep,0.728,0,642,134,720,5
287,11.48,99,61,20.5,very_deep,0.703,0,659,99,720,5
341,13.64,240,125,18.7,deep,0.824,201,546,441,671,4
343,13.72,148,75,20.1,very_deep,0.702,1014,579,1162,654,5
344,13.76,142,74,21.0,very_deep,0.588,1040,598,1182,672,5
345,13.80,151,77,20.0,very_deep,0.704,1080,640,1231,717,5
348,13.92,50,40,23.7,very_deep,0.366,0,194,50,234,5
349,13.96,49,40,24.1,very_deep,0.325,0,194,49,234,5
352,14.08,33,28,23.8,very_deep,0.374,0,202,33,230,5
353,14.12,32,27,23.8,very_deep,0.381,0,204,32,231,5
358,14.32,275,153,21.0,very_deep,0.492,1002,297,1277,450,5
359,14.36,265,157,22.2,very_deep,0.349,1015,298,1280,455,5
360,14.40,259,160,20.4,very_deep,0.595,1020,300,1279,460,5
361,14.44,256,162,20.0,very_deep,0.651,1024,302,1280,464,5
362,14.48,246,165,20.0,deep,0.670,1034,305,1280,470,4
363,14.52,241,163,19.7,deep,0.707,1039,313,1280,476,4
364,14.56,222,166,20.2,very_deep,0.669,1058,320,1280,486,5
365,14.60,209,163,19.7,deep,0.746,1071,326,1280,489,4
365,14.60,202,104,21.2,very_deep,0.521,923,484,1125,588,5
366,14.64,205,165,19.9,deep,0.728,1075,329,1280,494,4
366,14.64,184,98,21.9,very_deep,0.444,941,508,1125,606,5
367,14.68,198,168,19.9,deep,0.731,1082,331,1280,499,4
367,14.68,146,104,22.1,very_deep,0.480,962,519,1108,623,5
368,14.72,163,121,20.1,very_deep,0.729,988,547,1151,668,5
368,14.72,179,168,20.8,very_deep,0.641,1101,336,1280,504,5
369,14.76,168,158,21.0,very_deep,0.623,1111,347,1279,505,5
369,14.76,171,123,21.4,very_deep,0.556,1003,558,1174,681,5
370,14.80,158,164,20.8,very_deep,0.668,1122,350,1280,514,5
370,14.80,163,119,21.8,very_deep,0.513,1026,584,1189,703,5
371,14.84,154,162,20.5,very_deep,0.704,1126,353,1280,515,5
372,14.88,133,152,20.2,very_deep,0.766,1147,358,1280,510,5
373,14.92,121,144,20.6,very_deep,0.733,1159,362,1280,506,5
374,14.96,119,142,20.4,very_deep,0.753,1161,367,1280,509,5
375,15.00,94,135,22.5,very_deep,0.524,1185,379,1279,514,5
376,15.04,86,132,23.8,very_deep,0.373,1194,383,1280,515,5
455,18.20,223,118,20.3,very_deep,0.622,4,372,227,490,5
456,18.24,226,125,18.3,deep,0.898,3,378,229,503,4
457,18.28,201,129,18.7,deep,0.867,0,382,201,511,4
458,18.32,196,139,18.7,deep,0.882,5,394,201,533,4
459,18.36,197,144,18.6,deep,0.903,4,400,201,544,4
460,18.40,188,152,19.7,deep,0.771,0,404,188,556,4
461,18.44,188,158,19.0,deep,0.861,1,412,189,570,4
461,18.44,102,51,20.2,very_deep,0.705,0,196,102,247,5
462,18.48,169,180,18.7,deep,0.928,0,421,169,601,4
463,18.52,164,180,18.6,deep,0.940,0,431,164,611,4
464,18.56,152,190,18.9,deep,0.915,0,436,152,626,4
465,18.60,132,193,20.1,very_deep,0.779,0,458,132,651,5
465,18.60,83,46,20.7,very_deep,0.671,0,203,83,249,5
466,18.64,80,43,20.7,very_deep,0.667,0,204,80,247,5
466,18.64,117,180,21.6,very_deep,0.606,0,488,117,668,5
467,18.68,80,44,20.7,very_deep,0.670,0,205,80,249,5
467,18.68,108,152,22.4,very_deep,0.515,0,523,108,675,5
468,18.72,73,49,21.2,very_deep,0.642,0,205,73,254,5
468,18.72,79,156,23.0,very_deep,0.475,0,549,79,705,5
469,18.76,67,48,21.3,very_deep,0.639,0,205,67,253,5
470,18.80,65,49,21.6,very_deep,0.619,0,205,65,254,5
470,18.80,327,175,20.8,very_deep,0.462,951,291,1278,466,5
471,18.84,54,49,21.9,very_deep,0.610,0,205,54,254,5
471,18.84,326,179,21.6,very_deep,0.359,952,292,1278,471,5
472,18.88,50,50,21.8,very_deep,0.627,0,205,50,255,5
472,18.88,308,157,21.4,very_deep,0.402,971,319,1279,476,5
473,18.92,50,50,21.9,very_deep,0.615,0,205,50,255,5
473,18.92,299,163,21.1,very_deep,0.446,980,319,1279,482,5
474,18.96,46,50,22.4,very_deep,0.568,0,205,46,255,5
474,18.96,292,156,20.3,very_deep,0.560,987,325,1279,481,5
475,19.00,304,158,19.4,deep,0.678,975,328,1279,486,4
475,19.00,38,47,22.1,very_deep,0.611,0,209,38,256,5
476,19.04,297,161,19.2,deep,0.711,982,328,1279,489,4
476,19.04,37,45,22.5,very_deep,0.567,0,212,37,257,5
477,19.08,279,163,20.1,very_deep,0.616,1000,328,1279,491,5
477,19.08,33,43,22.8,very_deep,0.534,0,212,33,255,5
478,19.12,24,39,24.2,very_deep,0.393,0,216,24,255,5
478,19.12,251,171,22.5,very_deep,0.324,1027,324,1278,495,5
482,19.28,228,168,21.7,very_deep,0.464,1051,356,1279,524,5
486,19.44,175,167,23.4,very_deep,0.308,1105,386,1280,553,5
498,19.92,231,132,22.5,very_deep,0.329,31,557,262,689,5
499,19.96,249,139,21.1,very_deep,0.501,7,574,256,713,5
500,20.00,242,134,20.2,very_deep,0.627,0,586,242,720,5
581,23.24,215,120,22.2,very_deep,0.380,1064,259,1279,379,5
619,24.76,118,59,23.1,very_deep,0.321,917,432,1035,491,5
620,24.80,128,68,22.5,very_deep,0.400,929,435,1057,503,5
623,24.92,148,77,22.0,very_deep,0.448,974,480,1122,557,5
624,24.96,148,88,20.4,very_deep,0.687,985,484,1133,572,5
625,25.00,185,181,23.3,very_deep,0.310,0,523,185,704,5
627,25.08,188,115,20.6,very_deep,0.634,1035,526,1223,641,5
628,25.12,186,126,22.5,very_deep,0.388,1068,554,1254,680,5
645,25.80,96,51,22.4,very_deep,0.435,595,254,691,305,5
646,25.84,94,48,22.8,very_deep,0.384,597,258,691,306,5
647,25.88,97,54,23.3,very_deep,0.330,597,254,694,308,5
654,26.16,160,80,21.2,very_deep,0.543,1119,373,1279,453,5
655,26.20,127,88,20.7,very_deep,0.671,1152,386,1279,474,5
656,26.24,123,94,21.0,very_deep,0.647,1156,390,1279,484,5
675,27.00,232,119,18.4,deep,0.872,663,529,895,648,4
675,27.00,125,63,20.1,very_deep,0.707,652,419,777,482,5
676,27.04,223,125,18.3,deep,0.901,674,542,897,667,4
677,27.08,230,125,18.0,deep,0.928,674,559,904,684,4
678,27.12,190,115,18.7,deep,0.876,681,598,871,713,4
678,27.12,135,68,21.3,very_deep,0.545,678,461,813,529,5
680,27.20,144,76,19.3,deep,0.807,679,482,823,558,4
681,27.24,148,80,19.7,deep,0.761,685,499,833,579,4
681,27.24,91,49,22.1,very_deep,0.487,705,670,796,719,5
682,27.28,145,89,20.5,very_deep,0.681,697,529,842,618,5
683,27.32,144,92,18.9,deep,0.887,707,544,851,636,4
684,27.36,158,95,19.6,deep,0.786,709,564,867,659,4
685,27.40,167,95,19.3,deep,0.802,723,604,890,699,4
689,27.56,59,48,23.3,very_deep,0.416,1220,410,1279,458,5
